,year,Census_Tract_Code,County_Name,Jurisdiction,Proportion_Census_Tract_Covered,projectCount,projectCount_MF,projectCount_SF,qAboveMarket,qAffordable,qTot,qMFa,qSFa,qMFm,qSFm,shareRentMFm,shareRentSFm,shareRentMFa,shareRentSFa
0,2018,500100,Santa Clara County,San Jose,1.0,0,0,0,0,0,0,0,0,0,0,0.0,0.0,0.0,0.0
1,2019,500100,Santa Clara County,San Jose,1.0,0,0,0,0,0,0,0,0,0,0,0.0,0.0,0.0,0.0
2,2020,500100,Santa Clara County,San Jose,1.0,1,1,0,1,93,94,93,0,1,0,1.0,0.0,1.0,0.0
3,2021,500100,Santa Clara County,San Jose,1.0,0,0,0,0,0,0,0,0,0,0,0.0,0.0,0.0,0.0
4,2022,500100,Santa Clara County,San Jose,1.0,1,0,1,1,0,1,0,0,0,1,0.0,1.0,0.0,0.0
5,2023,500100,Santa Clara County,San Jose,1.0,4,0,4,4,0,4,0,0,0,4,0.0,1.0,0.0,0.0
6,2024,500100,Santa Clara County,San Jose,1.0,6,0,6,2,4,6,0,4,0,2,0.0,0.5,0.0,1.0
7,All,500100,Santa Clara County,San Jose,1.0,12,1,11,8,97,105,93,4,1,7,1.0,0.8571428571428571,1.0,1.0
8,2018,500200,Santa Clara County,San Jose,1.0,2,1,1,801,0,801,0,0,800,1,1.0,1.0,0.0,0.0
9,2019,500200,Santa Clara County,San Jose,1.0,1,1,0,28,87,115,87,0,28,0,1.0,0.0,1.0,0.0
10,2020,500200,Santa Clara County,San Jose,1.0,1,1,0,28,87,115,87,0,28,0,1.0,0.0,1.0,0.0
11,2021,500200,Santa Clara County,San Jose,1.0,0,0,0,0,0,0,0,0,0,0,0.0,0.0,0.0,0.0
12,2022,500200,Santa Clara County,San Jose,1.0,7,0,7,7,0,7,0,0,0,7,0.0,1.0,0.0,0.0
13,2023,500200,Santa Clara County,San Jose,1.0,5,2,3,5,0,5,0,0,2,3,0.0,1.0,0.0,0.0
14,2024,500200,Santa Clara County,San Jose,1.0,4,0,4,0,4,4,0,4,0,0,0.0,0.0,0.0,1.0
15,All,500200,Santa Clara County,San Jose,1.0,20,5,15,869,178,1047,174,4,858,11,0.9976689976689976,1.0,1.0,1.0
16,2018,500300,Santa Clara County,San Jose,1.0,1,1,0,19,0,19,0,0,19,0,0.0,0.0,0.0,0.0
17,2019,500300,Santa Clara County,San Jose,1.0,1,1,0,5900,0,5900,0,0,5900,0,1.0,0.0,0.0,0.0
18,2020,500300,Santa Clara County,San Jose,1.0,0,0,0,0,0,0,0,0,0,0,0.0,0.0,0.0,0.0
19,2021,500300,Santa Clara County,San Jose,1.0,1,1,0,497,0,497,0,0,497,0,1.0,0.0,0.0,0.0
20,2022,500300,Santa Clara County,San Jose,1.0,3,0,3,3,0,3,0,0,0,3,0.0,1.0,0.0,0.0
21,2023,500300,Santa Clara County,San Jose,1.0,4,1,3,15,0,15,0,0,12,3,1.0,1.0,0.0,0.0
22,2024,500300,Santa Clara County,San Jose,1.0,2,0,2,1,1,2,0,1,0,1,0.0,1.0,0.0,1.0
23,All,500300,Santa Clara County,San Jose,1.0,12,4,8,6435,1,6436,0,1,6428,7,0.9970441817050405,1.0,0.0,1.0
24,2018,500400,Santa Clara County,San Jose,1.0,0,0,0,0,0,0,0,0,0,0,0.0,0.0,0.0,0.0
25,2019,500400,Santa Clara County,San Jose,1.0,1,1,0,2,0,2,0,0,2,0,0.0,0.0,0.0,0.0
26,2020,500400,Santa Clara County,San Jose,1.0,1,0,1,8,0,8,0,0,0,8,0.0,0.0,0.0,0.0
27,2021,500400,Santa Clara County,San Jose,1.0,0,0,0,0,0,0,0,0,0,0,0.0,0.0,0.0,0.0
28,2022,500400,Santa Clara County,San Jose,1.0,5,1,4,7,4,11,2,2,2,5,1.0,1.0,1.0,1.0
29,2023,500400,Santa Clara County,San Jose,1.0,5,1,4,5,0,5,0,0,1,4,0.0,1.0,0.0,0.0
30,2024,500400,Santa Clara County,San Jose,1.0,2,0,2,0,2,2,0,2,0,0,0.0,0.0,0.0,1.0
31,All,500400,Santa Clara County,San Jose,1.0,14,3,11,22,6,28,2,4,5,17,0.4,0.5294117647058824,1.0,1.0
32,2018,500500,Santa Clara County,San Jose,1.0,0,0,0,0,0,0,0,0,0,0,0.0,0.0,0.0,0.0
33,2019,500500,Santa Clara County,San Jose,1.0,1,1,0,241,0,241,0,0,241,0,1.0,0.0,0.0,0.0
34,2020,500500,Santa Clara County,San Jose,1.0,0,0,0,0,0,0,0,0,0,0,0.0,0.0,0.0,0.0
35,2021,500500,Santa Clara County,San Jose,1.0,1,0,1,3,0,3,0,0,0,3,0.0,0.0,0.0,0.0
36,2022,500500,Santa Clara County,San Jose,1.0,10,0,10,10,0,10,0,0,0,10,0.0,1.0,0.0,0.0
37,2023,500500,Santa Clara County,San Jose,1.0,7,1,6,8,152,160,152,0,2,6,1.0,1.0,1.0,0.0
38,2024,500500,Santa Clara County,San Jose,1.0,11,0,11,2,9,11,0,9,0,2,0.0,0.0,0.0,1.0
39,All,500500,Santa Clara County,San Jose,1.0,30,2,28,264,161,425,152,9,243,21,1.0,0.7619047619047619,1.0,1.0
40,2018,500600,Santa Clara County,San Jose,1.0,1,0,1,1,0,1,0,0,0,1,0.0,1.0,0.0,0.0
41,2019,500600,Santa Clara County,San Jose,1.0,0,0,0,0,0,0,0,0,0,0,0.0,0.0,0.0,0.0
42,2020,500600,Santa Clara County,San Jose,1.0,0,0,0,0,0,0,0,0,0,0,0.0,0.0,0.0,0.0
43,2021,500600,Santa Clara County,San Jose,1.0,1,1,0,300,0,300,0,0,300,0,1.0,0.0,0.0,0.0
44,2022,500600,Santa Clara County,San Jose,1.0,10,0,10,10,0,10,0,0,0,10,0.0,1.0,0.0,0.0
45,2023,500600,Santa Clara County,San Jose,1.0,13,1,12,31,0,31,0,0,19,12,1.0,1.0,0.0,0.0
46,2024,500600,Santa Clara County,San Jose,1.0,6,0,6,1,5,6,0,5,0,1,0.0,1.0,0.0,1.0
47,All,500600,Santa Clara County,San Jose,1.0,31,2,29,343,5,348,0,5,319,24,1.0,1.0,0.0,1.0
48,2018,500800,Santa Clara County,San Jose,1.0,3,3,0,1247,0,1247,0,0,1247,0,1.0,0.0,0.0,0.0
49,2019,500800,Santa Clara County,San Jose,1.0,1,1,0,0,130,130,130,0,0,0,0.0,0.0,1.0,0.0
50,2020,500800,Santa Clara County,San Jose,1.0,3,3,0,469,9,478,9,0,469,0,0.3816631130063966,0.0,1.0,0.0
51,2021,500800,Santa Clara County,San Jose,1.0,2,2,0,390,0,390,0,0,390,0,1.0,0.0,0.0,0.0
52,2022,500800,Santa Clara County,San Jose,1.0,1,0,1,1,0,1,0,0,0,1,0.0,1.0,0.0,0.0
53,2023,500800,Santa Clara County,San Jose,1.0,0,0,0,0,0,0,0,0,0,0,0.0,0.0,0.0,0.0
54,2024,500800,Santa Clara County,San Jose,1.0,3,2,1,606,1,607,0,1,606,0,0.009900990099009901,0.0,0.0,1.0
55,All,500800,Santa Clara County,San Jose,1.0,13,11,2,2713,140,2853,139,1,2712,1,0.6718289085545722,1.0,1.0,1.0
56,2018,500901,Santa Clara County,San Jose,1.0,0,0,0,0,0,0,0,0,0,0,0.0,0.0,0.0,0.0
57,2019,500901,Santa Clara County,San Jose,1.0,0,0,0,0,0,0,0,0,0,0,0.0,0.0,0.0,0.0
58,2020,500901,Santa Clara County,San Jose,1.0,4,4,0,972,0,972,0,0,972,0,0.9629629629629629,0.0,0.0,0.0
59,2021,500901,Santa Clara County,San Jose,1.0,2,2,0,407,0,407,0,0,407,0,1.0,0.0,0.0,0.0
60,2022,500901,Santa Clara County,San Jose,1.0,0,0,0,0,0,0,0,0,0,0,0.0,0.0,0.0,0.0
61,2023,500901,Santa Clara County,San Jose,1.0,3,1,2,5,0,5,0,0,3,2,0.0,1.0,0.0,0.0
62,2024,500901,Santa Clara County,San Jose,1.0,2,2,0,1915,0,1915,0,0,1915,0,1.0,0.0,0.0,0.0
63,All,500901,Santa Clara County,San Jose,1.0,11,9,2,3299,0,3299,0,0,3297,2,0.9881710646041856,1.0,0.0,0.0
64,2018,500902,Santa Clara County,San Jose,1.0,0,0,0,0,0,0,0,0,0,0,0.0,0.0,0.0,0.0
65,2019,500902,Santa Clara County,San Jose,1.0,0,0,0,0,0,0,0,0,0,0,0.0,0.0,0.0,0.0
66,2020,500902,Santa Clara County,San Jose,1.0,0,0,0,0,0,0,0,0,0,0,0.0,0.0,0.0,0.0
67,2021,500902,Santa Clara County,San Jose,1.0,0,0,0,0,0,0,0,0,0,0,0.0,0.0,0.0,0.0
68,2022,500902,Santa Clara County,San Jose,1.0,1,0,1,1,0,1,0,0,0,1,0.0,1.0,0.0,0.0
69,2023,500902,Santa Clara County,San Jose,1.0,2,0,2,2,0,2,0,0,0,2,0.0,1.0,0.0,0.0
70,2024,500902,Santa Clara County,San Jose,1.0,2,0,2,0,2,2,0,2,0,0,0.0,0.0,0.0,1.0
71,All,500902,Santa Clara County,San Jose,1.0,5,0,5,3,2,5,0,2,0,3,0.0,1.0,0.0,1.0
72,2018,501000,Santa Clara County,San Jose,1.0,0,0,0,0,0,0,0,0,0,0,0.0,0.0,0.0,0.0
73,2019,501000,Santa Clara County,San Jose,1.0,1,1,0,298,0,298,0,0,298,0,1.0,0.0,0.0,0.0
74,2020,501000,Santa Clara County,San Jose,1.0,2,2,0,289,17,306,17,0,289,0,0.726643598615917,0.0,0.0,0.0
75,2021,501000,Santa Clara County,San Jose,1.0,3,3,0,442,0,442,0,0,442,0,1.0,0.0,0.0,0.0
76,2022,501000,Santa Clara County,San Jose,1.0,11,1,10,22,0,22,0,0,12,10,1.0,1.0,0.0,0.0
77,2023,501000,Santa Clara County,San Jose,1.0,2,1,1,101,18,119,18,0,100,1,1.0,1.0,1.0,0.0
78,2024,501000,Santa Clara County,San Jose,1.0,5,0,5,1,4,5,0,4,0,1,0.0,1.0,0.0,1.0
79,All,501000,Santa Clara County,San Jose,1.0,24,8,16,1153,39,1192,35,4,1141,12,0.9307624890446976,1.0,0.5142857142857142,1.0
80,2018,501101,Santa Clara County,San Jose,1.0,0,0,0,0,0,0,0,0,0,0,0.0,0.0,0.0,0.0
81,2019,501101,Santa Clara County,San Jose,1.0,1,1,0,2,0,2,0,0,2,0,0.0,0.0,0.0,0.0
82,2020,501101,Santa Clara County,San Jose,1.0,2,1,1,69,0,69,0,0,65,4,1.0,0.0,0.0,0.0
83,2021,501101,Santa Clara County,San Jose,1.0,1,1,0,2,0,2,0,0,2,0,1.0,0.0,0.0,0.0
84,2022,501101,Santa Clara County,San Jose,1.0,4,0,4,4,0,4,0,0,0,4,0.0,1.0,0.0,0.0
85,2023,501101,Santa Clara County,San Jose,1.0,2,0,2,2,0,2,0,0,0,2,0.0,1.0,0.0,0.0
86,2024,501101,Santa Clara County,San Jose,1.0,3,1,2,2,2,4,0,2,2,0,0.0,0.0,0.0,1.0
87,All,501101,Santa Clara County,San Jose,1.0,13,4,9,81,2,83,0,2,71,10,0.9436619718309859,0.6,0.0,1.0
88,2018,501102,Santa Clara County,San Jose,1.0,0,0,0,0,0,0,0,0,0,0,0.0,0.0,0.0,0.0
89,2019,501102,Santa Clara County,San Jose,1.0,0,0,0,0,0,0,0,0,0,0,0.0,0.0,0.0,0.0
90,2020,501102,Santa Clara County,San Jose,1.0,0,0,0,0,0,0,0,0,0,0,0.0,0.0,0.0,0.0
91,2021,501102,Santa Clara County,San Jose,1.0,0,0,0,0,0,0,0,0,0,0,0.0,0.0,0.0,0.0
92,2022,501102,Santa Clara County,San Jose,1.0,9,0,9,9,0,9,0,0,0,9,0.0,1.0,0.0,0.0
93,2023,501102,Santa Clara County,San Jose,1.0,5,0,5,5,0,5,0,0,0,5,0.0,0.8,0.0,0.0
94,2024,501102,Santa Clara County,San Jose,1.0,9,0,9,0,9,9,0,9,0,0,0.0,0.0,0.0,1.0
95,All,501102,Santa Clara County,San Jose,1.0,23,0,23,14,9,23,0,9,0,14,0.0,0.9285714285714286,0.0,1.0
96,2018,501200,Santa Clara County,San Jose,1.0,0,0,0,0,0,0,0,0,0,0,0.0,0.0,0.0,0.0
97,2019,501200,Santa Clara County,San Jose,1.0,0,0,0,0,0,0,0,0,0,0,0.0,0.0,0.0,0.0
98,2020,501200,Santa Clara County,San Jose,1.0,1,1,0,30,14,44,14,0,30,0,1.0,0.0,1.0,0.0
99,2021,501200,Santa Clara County,San Jose,1.0,2,2,0,330,332,662,332,0,330,0,1.0,0.0,1.0,0.0
100,2022,501200,Santa Clara County,San Jose,1.0,11,1,10,517,127,644,127,0,507,10,1.0,1.0,1.0,0.0
101,2023,501200,Santa Clara County,San Jose,1.0,9,2,7,48,214,262,214,0,41,7,1.0,0.8571428571428571,1.0,0.0
102,2024,501200,Santa Clara County,San Jose,1.0,7,0,7,0,7,7,0,7,0,0,0.0,0.0,0.0,1.0
103,All,501200,Santa Clara County,San Jose,1.0,30,6,24,925,694,1619,687,7,908,17,1.0,0.9411764705882353,1.0,1.0
104,2018,501300,Santa Clara County,San Jose,1.0,0,0,0,0,0,0,0,0,0,0,0.0,0.0,0.0,0.0
105,2019,501300,Santa Clara County,San Jose,1.0,0,0,0,0,0,0,0,0,0,0,0.0,0.0,0.0,0.0
106,2020,501300,Santa Clara County,San Jose,1.0,0,0,0,0,0,0,0,0,0,0,0.0,0.0,0.0,0.0
107,2021,501300,Santa Clara County,San Jose,1.0,0,0,0,0,0,0,0,0,0,0,0.0,0.0,0.0,0.0
108,2022,501300,Santa Clara County,San Jose,1.0,10,1,9,11,0,11,0,0,2,9,1.0,1.0,0.0,0.0
109,2023,501300,Santa Clara County,San Jose,1.0,3,0,3,3,0,3,0,0,0,3,0.0,1.0,0.0,0.0
110,2024,501300,Santa Clara County,San Jose,1.0,8,0,8,1,7,8,0,7,0,1,0.0,1.0,0.0,1.0
111,All,501300,Santa Clara County,San Jose,1.0,21,1,20,15,7,22,0,7,2,13,1.0,1.0,0.0,1.0
112,2018,501401,Santa Clara County,San Jose,1.0,0,0,0,0,0,0,0,0,0,0,0.0,0.0,0.0,0.0
113,2019,501401,Santa Clara County,San Jose,1.0,0,0,0,0,0,0,0,0,0,0,0.0,0.0,0.0,0.0
114,2020,501401,Santa Clara County,San Jose,1.0,1,1,0,1,90,91,90,0,1,0,1.0,0.0,1.0,0.0
115,2021,501401,Santa Clara County,San Jose,1.0,2,2,0,3,130,133,130,0,3,0,1.0,0.0,1.0,0.0
116,2022,501401,Santa Clara County,San Jose,1.0,6,6,0,705,308,1013,308,0,705,0,1.0,0.0,1.0,0.0
117,2023,501401,Santa Clara County,San Jose,1.0,2,1,1,20,0,20,0,0,19,1,1.0,1.0,0.0,0.0
118,2024,501401,Santa Clara County,San Jose,1.0,1,1,0,2,303,305,303,0,2,0,1.0,0.0,1.0,0.0
119,All,501401,Santa Clara County,San Jose,1.0,12,11,1,731,831,1562,831,0,730,1,1.0,1.0,1.0,0.0
120,2018,501402,Santa Clara County,San Jose,1.0,1,1,0,8,0,8,0,0,8,0,0.0,0.0,0.0,0.0
121,2019,501402,Santa Clara County,San Jose,1.0,1,1,0,1,0,1,0,0,1,0,1.0,0.0,0.0,0.0
122,2020,501402,Santa Clara County,San Jose,1.0,0,0,0,0,0,0,0,0,0,0,0.0,0.0,0.0,0.0
123,2021,501402,Santa Clara County,San Jose,1.0,0,0,0,0,0,0,0,0,0,0,0.0,0.0,0.0,0.0
124,2022,501402,Santa Clara County,San Jose,1.0,5,1,4,4,103,107,103,0,0,4,0.0,1.0,1.0,0.0
125,2023,501402,Santa Clara County,San Jose,1.0,3,0,3,3,0,3,0,0,0,3,0.0,1.0,0.0,0.0
126,2024,501402,Santa Clara County,San Jose,1.0,5,0,5,0,5,5,0,5,0,0,0.0,0.0,0.0,1.0
127,All,501402,Santa Clara County,San Jose,1.0,15,3,12,16,108,124,103,5,9,7,0.1111111111111111,1.0,1.0,1.0
128,2018,501501,Santa Clara County,San Jose,1.0,0,0,0,0,0,0,0,0,0,0,0.0,0.0,0.0,0.0
129,2019,501501,Santa Clara County,San Jose,1.0,0,0,0,0,0,0,0,0,0,0,0.0,0.0,0.0,0.0
130,2020,501501,Santa Clara County,San Jose,1.0,0,0,0,0,0,0,0,0,0,0,0.0,0.0,0.0,0.0
131,2021,501501,Santa Clara County,San Jose,1.0,0,0,0,0,0,0,0,0,0,0,0.0,0.0,0.0,0.0
132,2022,501501,Santa Clara County,San Jose,1.0,1,0,1,1,0,1,0,0,0,1,0.0,1.0,0.0,0.0
133,2023,501501,Santa Clara County,San Jose,1.0,2,1,1,3,0,3,0,0,2,1,0.0,1.0,0.0,0.0
134,2024,501501,Santa Clara County,San Jose,1.0,3,0,3,1,2,3,0,2,0,1,0.0,1.0,0.0,1.0
135,All,501501,Santa Clara County,San Jose,1.0,6,1,5,5,2,7,0,2,2,3,0.0,1.0,0.0,1.0
136,2018,501502,Santa Clara County,San Jose,1.0,0,0,0,0,0,0,0,0,0,0,0.0,0.0,0.0,0.0
137,2019,501502,Santa Clara County,San Jose,1.0,1,1,0,2,0,2,0,0,2,0,0.0,0.0,0.0,0.0
138,2020,501502,Santa Clara County,San Jose,1.0,0,0,0,0,0,0,0,0,0,0,0.0,0.0,0.0,0.0
139,2021,501502,Santa Clara County,San Jose,1.0,0,0,0,0,0,0,0,0,0,0,0.0,0.0,0.0,0.0
140,2022,501502,Santa Clara County,San Jose,1.0,3,0,3,3,0,3,0,0,0,3,0.0,1.0,0.0,0.0
141,2023,501502,Santa Clara County,San Jose,1.0,6,0,6,6,0,6,0,0,0,6,0.0,1.0,0.0,0.0
142,2024,501502,Santa Clara County,San Jose,1.0,1,1,0,2,0,2,0,0,2,0,0.0,0.0,0.0,0.0
143,All,501502,Santa Clara County,San Jose,1.0,11,2,9,13,0,13,0,0,4,9,0.0,1.0,0.0,0.0
144,2018,501601,Santa Clara County,San Jose,1.0,0,0,0,0,0,0,0,0,0,0,0.0,0.0,0.0,0.0
145,2019,501601,Santa Clara County,San Jose,1.0,1,1,0,35,312,347,312,0,35,0,1.0,0.0,1.0,0.0
146,2020,501601,Santa Clara County,San Jose,1.0,0,0,0,0,0,0,0,0,0,0,0.0,0.0,0.0,0.0
147,2021,501601,Santa Clara County,San Jose,1.0,1,1,0,246,0,246,0,0,246,0,1.0,0.0,0.0,0.0
148,2022,501601,Santa Clara County,San Jose,1.0,6,0,6,6,0,6,0,0,0,6,0.0,1.0,0.0,0.0
149,2023,501601,Santa Clara County,San Jose,1.0,6,0,6,6,0,6,0,0,0,6,0.0,0.8333333333333334,0.0,0.0
150,2024,501601,Santa Clara County,San Jose,1.0,2,0,2,0,2,2,0,2,0,0,0.0,0.0,0.0,1.0
151,All,501601,Santa Clara County,San Jose,1.0,16,2,14,293,314,607,312,2,281,12,1.0,0.9166666666666666,1.0,1.0
152,2018,501602,Santa Clara County,San Jose,1.0,2,2,0,957,0,957,0,0,957,0,1.0,0.0,0.0,0.0
153,2019,501602,Santa Clara County,San Jose,1.0,1,1,0,2,0,2,0,0,2,0,0.0,0.0,0.0,0.0
154,2020,501602,Santa Clara County,San Jose,1.0,2,2,0,437,169,606,169,0,437,0,0.2311212814645309,0.0,1.0,0.0
155,2021,501602,Santa Clara County,San Jose,1.0,0,0,0,0,0,0,0,0,0,0,0.0,0.0,0.0,0.0
156,2022,501602,Santa Clara County,San Jose,1.0,2,0,2,2,0,2,0,0,0,2,0.0,1.0,0.0,0.0
157,2023,501602,Santa Clara County,San Jose,1.0,2,0,2,2,0,2,0,0,0,2,0.0,1.0,0.0,0.0
158,2024,501602,Santa Clara County,San Jose,1.0,6,0,6,2,4,6,0,4,0,2,0.0,1.0,0.0,1.0
159,All,501602,Santa Clara County,San Jose,1.0,15,5,10,1402,173,1575,169,4,1396,6,0.7578796561604585,1.0,1.0,1.0
160,2018,501700,Santa Clara County,San Jose,1.0,3,2,1,132,86,218,86,0,131,1,1.0,1.0,1.0,0.0
161,2019,501700,Santa Clara County,San Jose,1.0,1,1,0,3,0,3,0,0,3,0,1.0,0.0,0.0,0.0
162,2020,501700,Santa Clara County,San Jose,1.0,0,0,0,0,0,0,0,0,0,0,0.0,0.0,0.0,0.0
163,2021,501700,Santa Clara County,San Jose,1.0,1,1,0,1,98,99,98,0,1,0,1.0,0.0,1.0,0.0
164,2022,501700,Santa Clara County,San Jose,1.0,5,1,4,4,237,241,237,0,0,4,0.0,0.75,1.0,0.0
165,2023,501700,Santa Clara County,San Jose,1.0,5,0,5,5,0,5,0,0,0,5,0.0,1.0,0.0,0.0
166,2024,501700,Santa Clara County,San Jose,1.0,5,1,4,3,221,224,218,3,2,1,1.0,1.0,1.0,1.0
167,All,501700,Santa Clara County,San Jose,1.0,20,6,14,148,642,790,639,3,137,11,1.0,0.9090909090909091,1.0,1.0
168,2018,501800,Santa Clara County,San Jose,1.0,0,0,0,0,0,0,0,0,0,0,0.0,0.0,0.0,0.0
169,2019,501800,Santa Clara County,San Jose,1.0,0,0,0,0,0,0,0,0,0,0,0.0,0.0,0.0,0.0
170,2020,501800,Santa Clara County,San Jose,1.0,0,0,0,0,0,0,0,0,0,0,0.0,0.0,0.0,0.0
171,2021,501800,Santa Clara County,San Jose,1.0,0,0,0,0,0,0,0,0,0,0,0.0,0.0,0.0,0.0
172,2022,501800,Santa Clara County,San Jose,1.0,15,0,15,15,0,15,0,0,0,15,0.0,0.9333333333333333,0.0,0.0
173,2023,501800,Santa Clara County,San Jose,1.0,14,1,13,31,0,31,0,0,18,13,1.0,1.0,0.0,0.0
174,2024,501800,Santa Clara County,San Jose,1.0,11,0,11,0,11,11,0,11,0,0,0.0,0.0,0.0,1.0
175,All,501800,Santa Clara County,San Jose,1.0,40,1,39,46,11,57,0,11,18,28,1.0,0.9642857142857143,0.0,1.0
176,2018,501901,Santa Clara County,San Jose,1.0,1,1,0,0,358,358,358,0,0,0,0.0,0.0,1.0,0.0
177,2019,501901,Santa Clara County,San Jose,1.0,2,2,0,196,114,310,114,0,196,0,1.0,0.0,1.0,0.0
178,2020,501901,Santa Clara County,San Jose,1.0,2,2,0,695,154,849,154,0,695,0,1.0,0.0,1.0,0.0
179,2021,501901,Santa Clara County,San Jose,1.0,2,2,0,327,65,392,65,0,327,0,1.0,0.0,1.0,0.0
180,2022,501901,Santa Clara County,San Jose,1.0,1,0,1,1,0,1,0,0,0,1,0.0,1.0,0.0,0.0
181,2023,501901,Santa Clara County,San Jose,1.0,2,0,2,2,0,2,0,0,0,2,0.0,1.0,0.0,0.0
182,2024,501901,Santa Clara County,San Jose,1.0,1,0,1,28,5,33,0,5,0,28,0.0,0.0,0.0,0.0
183,All,501901,Santa Clara County,San Jose,1.0,11,7,4,1249,696,1945,691,5,1218,31,1.0,0.0967741935483871,1.0,0.0
184,2018,501902,Santa Clara County,San Jose,1.0,1,1,0,12,0,12,0,0,12,0,1.0,0.0,0.0,0.0
185,2019,501902,Santa Clara County,San Jose,1.0,0,0,0,0,0,0,0,0,0,0,0.0,0.0,0.0,0.0
186,2020,501902,Santa Clara County,San Jose,1.0,0,0,0,0,0,0,0,0,0,0,0.0,0.0,0.0,0.0
187,2021,501902,Santa Clara County,San Jose,1.0,0,0,0,0,0,0,0,0,0,0,0.0,0.0,0.0,0.0
188,2022,501902,Santa Clara County,San Jose,1.0,0,0,0,0,0,0,0,0,0,0,0.0,0.0,0.0,0.0
189,2023,501902,Santa Clara County,San Jose,1.0,1,0,1,1,0,1,0,0,0,1,0.0,1.0,0.0,0.0
190,2024,501902,Santa Clara County,San Jose,1.0,0,0,0,0,0,0,0,0,0,0,0.0,0.0,0.0,0.0
191,All,501902,Santa Clara County,San Jose,1.0,2,1,1,13,0,13,0,0,12,1,1.0,1.0,0.0,0.0
192,2018,502001,Santa Clara County,San Jose,0.385,0,0,0,0,0,0,0,0,0,0,0.0,0.0,0.0,0.0
193,2019,502001,Santa Clara County,San Jose,0.385,0,0,0,0,0,0,0,0,0,0,0.0,0.0,0.0,0.0
194,2020,502001,Santa Clara County,San Jose,0.385,1,1,0,61,0,61,0,0,61,0,1.0,0.0,0.0,0.0
195,2021,502001,Santa Clara County,San Jose,0.385,0,0,0,0,0,0,0,0,0,0,0.0,0.0,0.0,0.0
196,2022,502001,Santa Clara County,San Jose,0.385,0,0,0,0,0,0,0,0,0,0,0.0,0.0,0.0,0.0
197,2023,502001,Santa Clara County,San Jose,0.385,3,0,3,3,0,3,0,0,0,3,0.0,0.6666666666666666,0.0,0.0
198,2024,502001,Santa Clara County,San Jose,0.385,2,1,1,1,1,2,0,1,1,0,1.0,0.0,0.0,1.0
199,All,502001,Santa Clara County,San Jose,0.385,6,2,4,65,1,66,0,1,62,3,1.0,0.6666666666666666,0.0,1.0
200,2018,502002,Santa Clara County,San Jose,0.762,1,1,0,29,0,29,0,0,29,0,1.0,0.0,0.0,0.0
201,2019,502002,Santa Clara County,San Jose,0.762,2,1,1,181,0,181,0,0,173,8,1.0,0.0,0.0,0.0
202,2020,502002,Santa Clara County,San Jose,0.762,0,0,0,0,0,0,0,0,0,0,0.0,0.0,0.0,0.0
203,2021,502002,Santa Clara County,San Jose,0.762,2,2,0,202,81,283,81,0,202,0,1.0,0.0,1.0,0.0
204,2022,502002,Santa Clara County,San Jose,0.762,3,0,3,3,0,3,0,0,0,3,0.0,1.0,0.0,0.0
205,2023,502002,Santa Clara County,San Jose,0.762,3,2,1,37,5,42,5,0,36,1,1.0,1.0,1.0,0.0
206,2024,502002,Santa Clara County,San Jose,0.762,5,0,5,0,5,5,0,5,0,0,0.0,0.0,0.0,1.0
207,All,502002,Santa Clara County,San Jose,0.762,16,6,10,452,91,543,86,5,440,12,1.0,0.3333333333333333,1.0,1.0
208,2018,502101,Santa Clara County,San Jose,0.553,0,0,0,0,0,0,0,0,0,0,0.0,0.0,0.0,0.0
209,2019,502101,Santa Clara County,San Jose,0.553,0,0,0,0,0,0,0,0,0,0,0.0,0.0,0.0,0.0
210,2020,502101,Santa Clara County,San Jose,0.553,0,0,0,0,0,0,0,0,0,0,0.0,0.0,0.0,0.0
211,2021,502101,Santa Clara County,San Jose,0.553,0,0,0,0,0,0,0,0,0,0,0.0,0.0,0.0,0.0
212,2022,502101,Santa Clara County,San Jose,0.553,0,0,0,0,0,0,0,0,0,0,0.0,0.0,0.0,0.0
213,2023,502101,Santa Clara County,San Jose,0.553,2,0,2,2,0,2,0,0,0,2,0.0,1.0,0.0,0.0
214,2024,502101,Santa Clara County,San Jose,0.553,2,0,2,1,1,2,0,1,0,1,0.0,1.0,0.0,1.0
215,All,502101,Santa Clara County,San Jose,0.553,4,0,4,3,1,4,0,1,0,3,0.0,1.0,0.0,1.0
216,2018,502103,Santa Clara County,San Jose,0.974,0,0,0,0,0,0,0,0,0,0,0.0,0.0,0.0,0.0
217,2019,502103,Santa Clara County,San Jose,0.974,1,1,0,2,106,108,106,0,2,0,1.0,0.0,1.0,0.0
218,2020,502103,Santa Clara County,San Jose,0.974,0,0,0,0,0,0,0,0,0,0,0.0,0.0,0.0,0.0
219,2021,502103,Santa Clara County,San Jose,0.974,0,0,0,0,0,0,0,0,0,0,0.0,0.0,0.0,0.0
220,2022,502103,Santa Clara County,San Jose,0.974,1,0,1,1,0,1,0,0,0,1,0.0,1.0,0.0,0.0
221,2023,502103,Santa Clara County,San Jose,0.974,0,0,0,0,0,0,0,0,0,0,0.0,0.0,0.0,0.0
222,2024,502103,Santa Clara County,San Jose,0.974,1,0,1,0,1,1,0,1,0,0,0.0,0.0,0.0,1.0
223,All,502103,Santa Clara County,San Jose,0.974,3,1,2,3,107,110,106,1,2,1,1.0,1.0,1.0,1.0
224,2018,502104,Santa Clara County,San Jose,1.0,1,1,0,590,0,590,0,0,590,0,1.0,0.0,0.0,0.0
225,2019,502104,Santa Clara County,San Jose,1.0,0,0,0,0,0,0,0,0,0,0,0.0,0.0,0.0,0.0
226,2020,502104,Santa Clara County,San Jose,1.0,0,0,0,0,0,0,0,0,0,0,0.0,0.0,0.0,0.0
227,2021,502104,Santa Clara County,San Jose,1.0,0,0,0,0,0,0,0,0,0,0,0.0,0.0,0.0,0.0
228,2022,502104,Santa Clara County,San Jose,1.0,0,0,0,0,0,0,0,0,0,0,0.0,0.0,0.0,0.0
229,2023,502104,Santa Clara County,San Jose,1.0,1,1,0,30,0,30,0,0,30,0,1.0,0.0,0.0,0.0
230,2024,502104,Santa Clara County,San Jose,1.0,2,0,2,0,2,2,0,2,0,0,0.0,0.0,0.0,1.0
231,All,502104,Santa Clara County,San Jose,1.0,4,2,2,620,2,622,0,2,620,0,1.0,0.0,0.0,1.0
232,2018,502202,Santa Clara County,San Jose,1.0,0,0,0,0,0,0,0,0,0,0,0.0,0.0,0.0,0.0
233,2019,502202,Santa Clara County,San Jose,1.0,0,0,0,0,0,0,0,0,0,0,0.0,0.0,0.0,0.0
234,2020,502202,Santa Clara County,San Jose,1.0,0,0,0,0,0,0,0,0,0,0,0.0,0.0,0.0,0.0
235,2021,502202,Santa Clara County,San Jose,1.0,0,0,0,0,0,0,0,0,0,0,0.0,0.0,0.0,0.0
236,2022,502202,Santa Clara County,San Jose,1.0,3,0,3,3,0,3,0,0,0,3,0.0,1.0,0.0,0.0
237,2023,502202,Santa Clara County,San Jose,1.0,2,0,2,2,0,2,0,0,0,2,0.0,1.0,0.0,0.0
238,2024,502202,Santa Clara County,San Jose,1.0,4,0,4,2,2,4,0,2,0,2,0.0,1.0,0.0,1.0
239,All,502202,Santa Clara County,San Jose,1.0,9,0,9,7,2,9,0,2,0,7,0.0,1.0,0.0,1.0
240,2018,502203,Santa Clara County,San Jose,1.0,0,0,0,0,0,0,0,0,0,0,0.0,0.0,0.0,0.0
241,2019,502203,Santa Clara County,San Jose,1.0,1,1,0,233,0,233,0,0,233,0,1.0,0.0,0.0,0.0
242,2020,502203,Santa Clara County,San Jose,1.0,0,0,0,0,0,0,0,0,0,0,0.0,0.0,0.0,0.0
243,2021,502203,Santa Clara County,San Jose,1.0,1,1,0,150,0,150,0,0,150,0,1.0,0.0,0.0,0.0
244,2022,502203,Santa Clara County,San Jose,1.0,0,0,0,0,0,0,0,0,0,0,0.0,0.0,0.0,0.0
245,2023,502203,Santa Clara County,San Jose,1.0,0,0,0,0,0,0,0,0,0,0,0.0,0.0,0.0,0.0
246,2024,502203,Santa Clara County,San Jose,1.0,1,0,1,0,1,1,0,1,0,0,0.0,0.0,0.0,1.0
247,All,502203,Santa Clara County,San Jose,1.0,3,2,1,383,1,384,0,1,383,0,1.0,0.0,0.0,1.0
248,2018,502204,Santa Clara County,San Jose,1.0,0,0,0,0,0,0,0,0,0,0,0.0,0.0,0.0,0.0
249,2019,502204,Santa Clara County,San Jose,1.0,0,0,0,0,0,0,0,0,0,0,0.0,0.0,0.0,0.0
250,2020,502204,Santa Clara County,San Jose,1.0,0,0,0,0,0,0,0,0,0,0,0.0,0.0,0.0,0.0
251,2021,502204,Santa Clara County,San Jose,1.0,0,0,0,0,0,0,0,0,0,0,0.0,0.0,0.0,0.0
252,2022,502204,Santa Clara County,San Jose,1.0,0,0,0,0,0,0,0,0,0,0,0.0,0.0,0.0,0.0
253,2023,502204,Santa Clara County,San Jose,1.0,0,0,0,0,0,0,0,0,0,0,0.0,0.0,0.0,0.0
254,2024,502204,Santa Clara County,San Jose,1.0,20,0,20,0,20,20,0,20,0,0,0.0,0.0,0.0,1.0
255,All,502204,Santa Clara County,San Jose,1.0,20,0,20,0,20,20,0,20,0,0,0.0,0.0,0.0,1.0
256,2018,502301,Santa Clara County,San Jose,1.0,1,1,0,4,0,4,0,0,4,0,0.0,0.0,0.0,0.0
257,2019,502301,Santa Clara County,San Jose,1.0,0,0,0,0,0,0,0,0,0,0,0.0,0.0,0.0,0.0
258,2020,502301,Santa Clara County,San Jose,1.0,0,0,0,0,0,0,0,0,0,0,0.0,0.0,0.0,0.0
259,2021,502301,Santa Clara County,San Jose,1.0,0,0,0,0,0,0,0,0,0,0,0.0,0.0,0.0,0.0
260,2022,502301,Santa Clara County,San Jose,1.0,4,0,4,4,0,4,0,0,0,4,0.0,1.0,0.0,0.0
261,2023,502301,Santa Clara County,San Jose,1.0,3,0,3,3,0,3,0,0,0,3,0.0,1.0,0.0,0.0
262,2024,502301,Santa Clara County,San Jose,1.0,11,0,11,7,5,12,0,5,0,7,0.0,0.0,0.0,1.0
263,All,502301,Santa Clara County,San Jose,1.0,19,1,18,18,5,23,0,5,4,14,0.0,0.5,0.0,1.0
264,2018,502302,Santa Clara County,San Jose,1.0,1,1,0,18,0,18,0,0,18,0,0.0,0.0,0.0,0.0
265,2019,502302,Santa Clara County,San Jose,1.0,1,1,0,3,0,3,0,0,3,0,1.0,0.0,0.0,0.0
266,2020,502302,Santa Clara County,San Jose,1.0,0,0,0,0,0,0,0,0,0,0,0.0,0.0,0.0,0.0
267,2021,502302,Santa Clara County,San Jose,1.0,0,0,0,0,0,0,0,0,0,0,0.0,0.0,0.0,0.0
268,2022,502302,Santa Clara County,San Jose,1.0,5,0,5,5,0,5,0,0,0,5,0.0,1.0,0.0,0.0
269,2023,502302,Santa Clara County,San Jose,1.0,2,0,2,2,0,2,0,0,0,2,0.0,1.0,0.0,0.0
270,2024,502302,Santa Clara County,San Jose,1.0,6,0,6,2,4,6,0,4,0,2,0.0,0.5,0.0,1.0
271,All,502302,Santa Clara County,San Jose,1.0,15,2,13,30,4,34,0,4,21,9,0.14285714285714285,0.8888888888888888,0.0,1.0
272,2018,502400,Santa Clara County,San Jose,1.0,0,0,0,0,0,0,0,0,0,0,0.0,0.0,0.0,0.0
273,2019,502400,Santa Clara County,San Jose,1.0,0,0,0,0,0,0,0,0,0,0,0.0,0.0,0.0,0.0
274,2020,502400,Santa Clara County,San Jose,1.0,0,0,0,0,0,0,0,0,0,0,0.0,0.0,0.0,0.0
275,2021,502400,Santa Clara County,San Jose,1.0,0,0,0,0,0,0,0,0,0,0,0.0,0.0,0.0,0.0
276,2022,502400,Santa Clara County,San Jose,1.0,10,0,10,10,0,10,0,0,0,10,0.0,1.0,0.0,0.0
277,2023,502400,Santa Clara County,San Jose,1.0,13,0,13,13,0,13,0,0,0,13,0.0,0.9230769230769231,0.0,0.0
278,2024,502400,Santa Clara County,San Jose,1.0,17,1,16,6,100,106,89,11,1,5,1.0,0.4,1.0,1.0
279,All,502400,Santa Clara County,San Jose,1.0,40,1,39,29,100,129,89,11,1,28,1.0,0.8571428571428571,1.0,1.0
280,2018,502500,Santa Clara County,San Jose,1.0,0,0,0,0,0,0,0,0,0,0,0.0,0.0,0.0,0.0
281,2019,502500,Santa Clara County,San Jose,1.0,0,0,0,0,0,0,0,0,0,0,0.0,0.0,0.0,0.0
282,2020,502500,Santa Clara County,San Jose,1.0,0,0,0,0,0,0,0,0,0,0,0.0,0.0,0.0,0.0
283,2021,502500,Santa Clara County,San Jose,1.0,0,0,0,0,0,0,0,0,0,0,0.0,0.0,0.0,0.0
284,2022,502500,Santa Clara County,San Jose,1.0,5,0,5,5,0,5,0,0,0,5,0.0,1.0,0.0,0.0
285,2023,502500,Santa Clara County,San Jose,1.0,15,1,14,15,0,15,0,0,1,14,0.0,1.0,0.0,0.0
286,2024,502500,Santa Clara County,San Jose,1.0,18,1,17,5,13,18,0,13,1,4,1.0,1.0,0.0,1.0
287,All,502500,Santa Clara County,San Jose,1.0,38,2,36,25,13,38,0,13,2,23,0.5,1.0,0.0,1.0
288,2018,502601,Santa Clara County,San Jose,0.856,0,0,0,0,0,0,0,0,0,0,0.0,0.0,0.0,0.0
289,2019,502601,Santa Clara County,San Jose,0.856,0,0,0,0,0,0,0,0,0,0,0.0,0.0,0.0,0.0
290,2020,502601,Santa Clara County,San Jose,0.856,0,0,0,0,0,0,0,0,0,0,0.0,0.0,0.0,0.0
291,2021,502601,Santa Clara County,San Jose,0.856,0,0,0,0,0,0,0,0,0,0,0.0,0.0,0.0,0.0
292,2022,502601,Santa Clara County,San Jose,0.856,1,0,1,1,0,1,0,0,0,1,0.0,1.0,0.0,0.0
293,2023,502601,Santa Clara County,San Jose,0.856,1,0,1,1,0,1,0,0,0,1,0.0,1.0,0.0,0.0
294,2024,502601,Santa Clara County,San Jose,0.856,3,0,3,1,2,3,0,2,0,1,0.0,1.0,0.0,1.0
295,All,502601,Santa Clara County,San Jose,0.856,5,0,5,3,2,5,0,2,0,3,0.0,1.0,0.0,1.0
296,2018,502603,Santa Clara County,San Jose,0.058,0,0,0,0,0,0,0,0,0,0,0.0,0.0,0.0,0.0
297,2019,502603,Santa Clara County,San Jose,0.058,0,0,0,0,0,0,0,0,0,0,0.0,0.0,0.0,0.0
298,2020,502603,Santa Clara County,San Jose,0.058,0,0,0,0,0,0,0,0,0,0,0.0,0.0,0.0,0.0
299,2021,502603,Santa Clara County,San Jose,0.058,1,1,0,0,123,123,123,0,0,0,0.0,0.0,1.0,0.0
300,2022,502603,Santa Clara County,San Jose,0.058,0,0,0,0,0,0,0,0,0,0,0.0,0.0,0.0,0.0
301,2023,502603,Santa Clara County,San Jose,0.058,0,0,0,0,0,0,0,0,0,0,0.0,0.0,0.0,0.0
302,2024,502603,Santa Clara County,San Jose,0.058,0,0,0,0,0,0,0,0,0,0,0.0,0.0,0.0,0.0
303,All,502603,Santa Clara County,San Jose,0.058,1,1,0,0,123,123,123,0,0,0,0.0,0.0,1.0,0.0
304,2018,502604,Santa Clara County,San Jose,0.073,0,0,0,0,0,0,0,0,0,0,0.0,0.0,0.0,0.0
305,2019,502604,Santa Clara County,San Jose,0.073,0,0,0,0,0,0,0,0,0,0,0.0,0.0,0.0,0.0
306,2020,502604,Santa Clara County,San Jose,0.073,0,0,0,0,0,0,0,0,0,0,0.0,0.0,0.0,0.0
307,2021,502604,Santa Clara County,San Jose,0.073,0,0,0,0,0,0,0,0,0,0,0.0,0.0,0.0,0.0
308,2022,502604,Santa Clara County,San Jose,0.073,0,0,0,0,0,0,0,0,0,0,0.0,0.0,0.0,0.0
309,2023,502604,Santa Clara County,San Jose,0.073,0,0,0,0,0,0,0,0,0,0,0.0,0.0,0.0,0.0
310,2024,502604,Santa Clara County,San Jose,0.073,0,0,0,0,0,0,0,0,0,0,0.0,0.0,0.0,0.0
311,All,502604,Santa Clara County,San Jose,0.073,0,0,0,0,0,0,0,0,0,0,0.0,0.0,0.0,0.0
312,2018,502701,Santa Clara County,San Jose,0.602,0,0,0,0,0,0,0,0,0,0,0.0,0.0,0.0,0.0
313,2019,502701,Santa Clara County,San Jose,0.602,1,1,0,83,0,83,0,0,83,0,1.0,0.0,0.0,0.0
314,2020,502701,Santa Clara County,San Jose,0.602,2,1,1,40,79,119,79,0,0,40,0.0,0.0,1.0,0.0
315,2021,502701,Santa Clara County,San Jose,0.602,0,0,0,0,0,0,0,0,0,0,0.0,0.0,0.0,0.0
316,2022,502701,Santa Clara County,San Jose,0.602,2,0,2,2,0,2,0,0,0,2,0.0,1.0,0.0,0.0
317,2023,502701,Santa Clara County,San Jose,0.602,39,0,39,39,0,39,0,0,0,39,0.0,0.46153846153846156,0.0,0.0
318,2024,502701,Santa Clara County,San Jose,0.602,2,0,2,1,1,2,0,1,0,1,0.0,0.0,0.0,1.0
319,All,502701,Santa Clara County,San Jose,0.602,46,2,44,165,80,245,79,1,83,82,1.0,0.24390243902439024,1.0,1.0
320,2018,502703,Santa Clara County,San Jose,0.4,0,0,0,0,0,0,0,0,0,0,0.0,0.0,0.0,0.0
321,2019,502703,Santa Clara County,San Jose,0.4,0,0,0,0,0,0,0,0,0,0,0.0,0.0,0.0,0.0
322,2020,502703,Santa Clara County,San Jose,0.4,0,0,0,0,0,0,0,0,0,0,0.0,0.0,0.0,0.0
323,2021,502703,Santa Clara County,San Jose,0.4,0,0,0,0,0,0,0,0,0,0,0.0,0.0,0.0,0.0
324,2022,502703,Santa Clara County,San Jose,0.4,1,0,1,1,0,1,0,0,0,1,0.0,1.0,0.0,0.0
325,2023,502703,Santa Clara County,San Jose,0.4,1,0,1,1,0,1,0,0,0,1,0.0,1.0,0.0,0.0
326,2024,502703,Santa Clara County,San Jose,0.4,3,0,3,1,2,3,0,2,0,1,0.0,1.0,0.0,1.0
327,All,502703,Santa Clara County,San Jose,0.4,5,0,5,3,2,5,0,2,0,3,0.0,1.0,0.0,1.0
328,2018,502704,Santa Clara County,San Jose,0.758,0,0,0,0,0,0,0,0,0,0,0.0,0.0,0.0,0.0
329,2019,502704,Santa Clara County,San Jose,0.758,0,0,0,0,0,0,0,0,0,0,0.0,0.0,0.0,0.0
330,2020,502704,Santa Clara County,San Jose,0.758,0,0,0,0,0,0,0,0,0,0,0.0,0.0,0.0,0.0
331,2021,502704,Santa Clara County,San Jose,0.758,0,0,0,0,0,0,0,0,0,0,0.0,0.0,0.0,0.0
332,2022,502704,Santa Clara County,San Jose,0.758,0,0,0,0,0,0,0,0,0,0,0.0,0.0,0.0,0.0
333,2023,502704,Santa Clara County,San Jose,0.758,0,0,0,0,0,0,0,0,0,0,0.0,0.0,0.0,0.0
334,2024,502704,Santa Clara County,San Jose,0.758,1,0,1,0,1,1,0,1,0,0,0.0,0.0,0.0,1.0
335,All,502704,Santa Clara County,San Jose,0.758,1,0,1,0,1,1,0,1,0,0,0.0,0.0,0.0,1.0
336,2018,502800,Santa Clara County,San Jose,0.396,0,0,0,0,0,0,0,0,0,0,0.0,0.0,0.0,0.0
337,2019,502800,Santa Clara County,San Jose,0.396,0,0,0,0,0,0,0,0,0,0,0.0,0.0,0.0,0.0
338,2020,502800,Santa Clara County,San Jose,0.396,0,0,0,0,0,0,0,0,0,0,0.0,0.0,0.0,0.0
339,2021,502800,Santa Clara County,San Jose,0.396,1,0,1,7,0,7,0,0,0,7,0.0,0.0,0.0,0.0
340,2022,502800,Santa Clara County,San Jose,0.396,1,0,1,1,0,1,0,0,0,1,0.0,1.0,0.0,0.0
341,2023,502800,Santa Clara County,San Jose,0.396,2,0,2,2,0,2,0,0,0,2,0.0,1.0,0.0,0.0
342,2024,502800,Santa Clara County,San Jose,0.396,11,0,11,8,3,11,0,3,0,8,0.0,0.0,0.0,1.0
343,All,502800,Santa Clara County,San Jose,0.396,15,0,15,18,3,21,0,3,0,18,0.0,0.16666666666666666,0.0,1.0
344,2018,502901,Santa Clara County,San Jose,1.0,0,0,0,0,0,0,0,0,0,0,0.0,0.0,0.0,0.0
345,2019,502901,Santa Clara County,San Jose,1.0,0,0,0,0,0,0,0,0,0,0,0.0,0.0,0.0,0.0
346,2020,502901,Santa Clara County,San Jose,1.0,0,0,0,0,0,0,0,0,0,0,0.0,0.0,0.0,0.0
347,2021,502901,Santa Clara County,San Jose,1.0,0,0,0,0,0,0,0,0,0,0,0.0,0.0,0.0,0.0
348,2022,502901,Santa Clara County,San Jose,1.0,6,2,4,5,323,328,323,0,1,4,1.0,1.0,1.0,0.0
349,2023,502901,Santa Clara County,San Jose,1.0,2,0,2,2,0,2,0,0,0,2,0.0,1.0,0.0,0.0
350,2024,502901,Santa Clara County,San Jose,1.0,42,3,39,25,108,133,89,19,5,20,0.2,0.05,1.0,1.0
351,All,502901,Santa Clara County,San Jose,1.0,50,5,45,32,431,463,412,19,6,26,0.3333333333333333,0.2692307692307692,1.0,1.0
352,2018,502902,Santa Clara County,San Jose,1.0,0,0,0,0,0,0,0,0,0,0,0.0,0.0,0.0,0.0
353,2019,502902,Santa Clara County,San Jose,1.0,0,0,0,0,0,0,0,0,0,0,0.0,0.0,0.0,0.0
354,2020,502902,Santa Clara County,San Jose,1.0,0,0,0,0,0,0,0,0,0,0,0.0,0.0,0.0,0.0
355,2021,502902,Santa Clara County,San Jose,1.0,0,0,0,0,0,0,0,0,0,0,0.0,0.0,0.0,0.0
356,2022,502902,Santa Clara County,San Jose,1.0,6,0,6,6,0,6,0,0,0,6,0.0,1.0,0.0,0.0
357,2023,502902,Santa Clara County,San Jose,1.0,6,0,6,12,0,12,0,0,0,12,0.0,0.4166666666666667,0.0,0.0
358,2024,502902,Santa Clara County,San Jose,1.0,4,0,4,0,4,4,0,4,0,0,0.0,0.0,0.0,1.0
359,All,502902,Santa Clara County,San Jose,1.0,16,0,16,18,4,22,0,4,0,18,0.0,0.6111111111111112,0.0,1.0
360,2018,502903,Santa Clara County,San Jose,1.0,0,0,0,0,0,0,0,0,0,0,0.0,0.0,0.0,0.0
361,2019,502903,Santa Clara County,San Jose,1.0,0,0,0,0,0,0,0,0,0,0,0.0,0.0,0.0,0.0
362,2020,502903,Santa Clara County,San Jose,1.0,0,0,0,0,0,0,0,0,0,0,0.0,0.0,0.0,0.0
363,2021,502903,Santa Clara County,San Jose,1.0,0,0,0,0,0,0,0,0,0,0,0.0,0.0,0.0,0.0
364,2022,502903,Santa Clara County,San Jose,1.0,1,0,1,1,0,1,0,0,0,1,0.0,1.0,0.0,0.0
365,2023,502903,Santa Clara County,San Jose,1.0,2,0,2,2,0,2,0,0,0,2,0.0,1.0,0.0,0.0
366,2024,502903,Santa Clara County,San Jose,1.0,4,0,4,0,4,4,0,4,0,0,0.0,0.0,0.0,1.0
367,All,502903,Santa Clara County,San Jose,1.0,7,0,7,3,4,7,0,4,0,3,0.0,1.0,0.0,1.0
368,2018,502906,Santa Clara County,San Jose,1.0,0,0,0,0,0,0,0,0,0,0,0.0,0.0,0.0,0.0
369,2019,502906,Santa Clara County,San Jose,1.0,0,0,0,0,0,0,0,0,0,0,0.0,0.0,0.0,0.0
370,2020,502906,Santa Clara County,San Jose,1.0,0,0,0,0,0,0,0,0,0,0,0.0,0.0,0.0,0.0
371,2021,502906,Santa Clara County,San Jose,1.0,0,0,0,0,0,0,0,0,0,0,0.0,0.0,0.0,0.0
372,2022,502906,Santa Clara County,San Jose,1.0,2,0,2,2,0,2,0,0,0,2,0.0,1.0,0.0,0.0
373,2023,502906,Santa Clara County,San Jose,1.0,4,0,4,4,0,4,0,0,0,4,0.0,1.0,0.0,0.0
374,2024,502906,Santa Clara County,San Jose,1.0,2,0,2,0,2,2,0,2,0,0,0.0,0.0,0.0,1.0
375,All,502906,Santa Clara County,San Jose,1.0,8,0,8,6,2,8,0,2,0,6,0.0,1.0,0.0,1.0
376,2018,502907,Santa Clara County,San Jose,1.0,0,0,0,0,0,0,0,0,0,0,0.0,0.0,0.0,0.0
377,2019,502907,Santa Clara County,San Jose,1.0,0,0,0,0,0,0,0,0,0,0,0.0,0.0,0.0,0.0
378,2020,502907,Santa Clara County,San Jose,1.0,0,0,0,0,0,0,0,0,0,0,0.0,0.0,0.0,0.0
379,2021,502907,Santa Clara County,San Jose,1.0,0,0,0,0,0,0,0,0,0,0,0.0,0.0,0.0,0.0
380,2022,502907,Santa Clara County,San Jose,1.0,2,0,2,2,0,2,0,0,0,2,0.0,1.0,0.0,0.0
381,2023,502907,Santa Clara County,San Jose,1.0,2,0,2,2,0,2,0,0,0,2,0.0,1.0,0.0,0.0
382,2024,502907,Santa Clara County,San Jose,1.0,6,0,6,1,5,6,0,5,0,1,0.0,1.0,0.0,1.0
383,All,502907,Santa Clara County,San Jose,1.0,10,0,10,5,5,10,0,5,0,5,0.0,1.0,0.0,1.0
384,2018,502908,Santa Clara County,San Jose,1.0,0,0,0,0,0,0,0,0,0,0,0.0,0.0,0.0,0.0
385,2019,502908,Santa Clara County,San Jose,1.0,0,0,0,0,0,0,0,0,0,0,0.0,0.0,0.0,0.0
386,2020,502908,Santa Clara County,San Jose,1.0,0,0,0,0,0,0,0,0,0,0,0.0,0.0,0.0,0.0
387,2021,502908,Santa Clara County,San Jose,1.0,0,0,0,0,0,0,0,0,0,0,0.0,0.0,0.0,0.0
388,2022,502908,Santa Clara County,San Jose,1.0,7,0,7,7,0,7,0,0,0,7,0.0,1.0,0.0,0.0
389,2023,502908,Santa Clara County,San Jose,1.0,7,0,7,7,0,7,0,0,0,7,0.0,1.0,0.0,0.0
390,2024,502908,Santa Clara County,San Jose,1.0,3,0,3,0,3,3,0,3,0,0,0.0,0.0,0.0,1.0
391,All,502908,Santa Clara County,San Jose,1.0,17,0,17,14,3,17,0,3,0,14,0.0,1.0,0.0,1.0
392,2018,502909,Santa Clara County,San Jose,1.0,0,0,0,0,0,0,0,0,0,0,0.0,0.0,0.0,0.0
393,2019,502909,Santa Clara County,San Jose,1.0,0,0,0,0,0,0,0,0,0,0,0.0,0.0,0.0,0.0
394,2020,502909,Santa Clara County,San Jose,1.0,0,0,0,0,0,0,0,0,0,0,0.0,0.0,0.0,0.0
395,2021,502909,Santa Clara County,San Jose,1.0,0,0,0,0,0,0,0,0,0,0,0.0,0.0,0.0,0.0
396,2022,502909,Santa Clara County,San Jose,1.0,1,0,1,1,0,1,0,0,0,1,0.0,1.0,0.0,0.0
397,2023,502909,Santa Clara County,San Jose,1.0,0,0,0,0,0,0,0,0,0,0,0.0,0.0,0.0,0.0
398,2024,502909,Santa Clara County,San Jose,1.0,0,0,0,0,0,0,0,0,0,0,0.0,0.0,0.0,0.0
399,All,502909,Santa Clara County,San Jose,1.0,1,0,1,1,0,1,0,0,0,1,0.0,1.0,0.0,0.0
400,2018,502910,Santa Clara County,San Jose,1.0,0,0,0,0,0,0,0,0,0,0,0.0,0.0,0.0,0.0
401,2019,502910,Santa Clara County,San Jose,1.0,0,0,0,0,0,0,0,0,0,0,0.0,0.0,0.0,0.0
402,2020,502910,Santa Clara County,San Jose,1.0,0,0,0,0,0,0,0,0,0,0,0.0,0.0,0.0,0.0
403,2021,502910,Santa Clara County,San Jose,1.0,0,0,0,0,0,0,0,0,0,0,0.0,0.0,0.0,0.0
404,2022,502910,Santa Clara County,San Jose,1.0,0,0,0,0,0,0,0,0,0,0,0.0,0.0,0.0,0.0
405,2023,502910,Santa Clara County,San Jose,1.0,0,0,0,0,0,0,0,0,0,0,0.0,0.0,0.0,0.0
406,2024,502910,Santa Clara County,San Jose,1.0,1,0,1,0,1,1,0,1,0,0,0.0,0.0,0.0,1.0
407,All,502910,Santa Clara County,San Jose,1.0,1,0,1,0,1,1,0,1,0,0,0.0,0.0,0.0,1.0
408,2018,503001,Santa Clara County,San Jose,1.0,0,0,0,0,0,0,0,0,0,0,0.0,0.0,0.0,0.0
409,2019,503001,Santa Clara County,San Jose,1.0,0,0,0,0,0,0,0,0,0,0,0.0,0.0,0.0,0.0
410,2020,503001,Santa Clara County,San Jose,1.0,0,0,0,0,0,0,0,0,0,0,0.0,0.0,0.0,0.0
411,2021,503001,Santa Clara County,San Jose,1.0,0,0,0,0,0,0,0,0,0,0,0.0,0.0,0.0,0.0
412,2022,503001,Santa Clara County,San Jose,1.0,8,0,8,8,0,8,0,0,0,8,0.0,1.0,0.0,0.0
413,2023,503001,Santa Clara County,San Jose,1.0,11,0,11,11,0,11,0,0,0,11,0.0,1.0,0.0,0.0
414,2024,503001,Santa Clara County,San Jose,1.0,5,0,5,0,5,5,0,5,0,0,0.0,0.0,0.0,1.0
415,All,503001,Santa Clara County,San Jose,1.0,24,0,24,19,5,24,0,5,0,19,0.0,1.0,0.0,1.0
416,2018,503002,Santa Clara County,San Jose,1.0,0,0,0,0,0,0,0,0,0,0,0.0,0.0,0.0,0.0
417,2019,503002,Santa Clara County,San Jose,1.0,0,0,0,0,0,0,0,0,0,0,0.0,0.0,0.0,0.0
418,2020,503002,Santa Clara County,San Jose,1.0,0,0,0,0,0,0,0,0,0,0,0.0,0.0,0.0,0.0
419,2021,503002,Santa Clara County,San Jose,1.0,0,0,0,0,0,0,0,0,0,0,0.0,0.0,0.0,0.0
420,2022,503002,Santa Clara County,San Jose,1.0,8,0,8,8,0,8,0,0,0,8,0.0,1.0,0.0,0.0
421,2023,503002,Santa Clara County,San Jose,1.0,1,0,1,1,0,1,0,0,0,1,0.0,1.0,0.0,0.0
422,2024,503002,Santa Clara County,San Jose,1.0,0,0,0,0,0,0,0,0,0,0,0.0,0.0,0.0,0.0
423,All,503002,Santa Clara County,San Jose,1.0,9,0,9,9,0,9,0,0,0,9,0.0,1.0,0.0,0.0
424,2018,503003,Santa Clara County,San Jose,1.0,0,0,0,0,0,0,0,0,0,0,0.0,0.0,0.0,0.0
425,2019,503003,Santa Clara County,San Jose,1.0,0,0,0,0,0,0,0,0,0,0,0.0,0.0,0.0,0.0
426,2020,503003,Santa Clara County,San Jose,1.0,0,0,0,0,0,0,0,0,0,0,0.0,0.0,0.0,0.0
427,2021,503003,Santa Clara County,San Jose,1.0,0,0,0,0,0,0,0,0,0,0,0.0,0.0,0.0,0.0
428,2022,503003,Santa Clara County,San Jose,1.0,4,0,4,4,0,4,0,0,0,4,0.0,1.0,0.0,0.0
429,2023,503003,Santa Clara County,San Jose,1.0,3,0,3,3,0,3,0,0,0,3,0.0,1.0,0.0,0.0
430,2024,503003,Santa Clara County,San Jose,1.0,5,1,4,3,162,165,160,2,1,2,1.0,1.0,1.0,1.0
431,All,503003,Santa Clara County,San Jose,1.0,12,1,11,10,162,172,160,2,1,9,1.0,1.0,1.0,1.0
432,2018,503105,Santa Clara County,San Jose,1.0,0,0,0,0,0,0,0,0,0,0,0.0,0.0,0.0,0.0
433,2019,503105,Santa Clara County,San Jose,1.0,0,0,0,0,0,0,0,0,0,0,0.0,0.0,0.0,0.0
434,2020,503105,Santa Clara County,San Jose,1.0,0,0,0,0,0,0,0,0,0,0,0.0,0.0,0.0,0.0
435,2021,503105,Santa Clara County,San Jose,1.0,0,0,0,0,0,0,0,0,0,0,0.0,0.0,0.0,0.0
436,2022,503105,Santa Clara County,San Jose,1.0,1,0,1,1,0,1,0,0,0,1,0.0,1.0,0.0,0.0
437,2023,503105,Santa Clara County,San Jose,1.0,4,0,4,4,0,4,0,0,0,4,0.0,0.25,0.0,0.0
438,2024,503105,Santa Clara County,San Jose,1.0,3,0,3,16,1,17,0,1,0,16,0.0,0.0,0.0,1.0
439,All,503105,Santa Clara County,San Jose,1.0,8,0,8,21,1,22,0,1,0,21,0.0,0.09523809523809523,0.0,1.0
440,2018,503110,Santa Clara County,San Jose,1.0,0,0,0,0,0,0,0,0,0,0,0.0,0.0,0.0,0.0
441,2019,503110,Santa Clara County,San Jose,1.0,0,0,0,0,0,0,0,0,0,0,0.0,0.0,0.0,0.0
442,2020,503110,Santa Clara County,San Jose,1.0,0,0,0,0,0,0,0,0,0,0,0.0,0.0,0.0,0.0
443,2021,503110,Santa Clara County,San Jose,1.0,0,0,0,0,0,0,0,0,0,0,0.0,0.0,0.0,0.0
444,2022,503110,Santa Clara County,San Jose,1.0,0,0,0,0,0,0,0,0,0,0,0.0,0.0,0.0,0.0
445,2023,503110,Santa Clara County,San Jose,1.0,1,0,1,1,0,1,0,0,0,1,0.0,1.0,0.0,0.0
446,2024,503110,Santa Clara County,San Jose,1.0,2,0,2,0,2,2,0,2,0,0,0.0,0.0,0.0,1.0
447,All,503110,Santa Clara County,San Jose,1.0,3,0,3,1,2,3,0,2,0,1,0.0,1.0,0.0,1.0
448,2018,503111,Santa Clara County,San Jose,1.0,0,0,0,0,0,0,0,0,0,0,0.0,0.0,0.0,0.0
449,2019,503111,Santa Clara County,San Jose,1.0,0,0,0,0,0,0,0,0,0,0,0.0,0.0,0.0,0.0
450,2020,503111,Santa Clara County,San Jose,1.0,0,0,0,0,0,0,0,0,0,0,0.0,0.0,0.0,0.0
451,2021,503111,Santa Clara County,San Jose,1.0,0,0,0,0,0,0,0,0,0,0,0.0,0.0,0.0,0.0
452,2022,503111,Santa Clara County,San Jose,1.0,4,0,4,4,0,4,0,0,0,4,0.0,1.0,0.0,0.0
453,2023,503111,Santa Clara County,San Jose,1.0,3,0,3,3,0,3,0,0,0,3,0.0,1.0,0.0,0.0
454,2024,503111,Santa Clara County,San Jose,1.0,6,0,6,0,6,6,0,6,0,0,0.0,0.0,0.0,1.0
455,All,503111,Santa Clara County,San Jose,1.0,13,0,13,7,6,13,0,6,0,7,0.0,1.0,0.0,1.0
456,2018,503112,Santa Clara County,San Jose,1.0,0,0,0,0,0,0,0,0,0,0,0.0,0.0,0.0,0.0
457,2019,503112,Santa Clara County,San Jose,1.0,0,0,0,0,0,0,0,0,0,0,0.0,0.0,0.0,0.0
458,2020,503112,Santa Clara County,San Jose,1.0,0,0,0,0,0,0,0,0,0,0,0.0,0.0,0.0,0.0
459,2021,503112,Santa Clara County,San Jose,1.0,3,3,0,90,99,189,99,0,90,0,1.0,0.0,1.0,0.0
460,2022,503112,Santa Clara County,San Jose,1.0,3,0,3,3,0,3,0,0,0,3,0.0,1.0,0.0,0.0
461,2023,503112,Santa Clara County,San Jose,1.0,3,0,3,3,0,3,0,0,0,3,0.0,1.0,0.0,0.0
462,2024,503112,Santa Clara County,San Jose,1.0,7,1,6,2,5,7,0,5,1,1,1.0,1.0,0.0,1.0
463,All,503112,Santa Clara County,San Jose,1.0,16,4,12,98,104,202,99,5,91,7,1.0,1.0,1.0,1.0
464,2018,503113,Santa Clara County,San Jose,1.0,0,0,0,0,0,0,0,0,0,0,0.0,0.0,0.0,0.0
465,2019,503113,Santa Clara County,San Jose,1.0,0,0,0,0,0,0,0,0,0,0,0.0,0.0,0.0,0.0
466,2020,503113,Santa Clara County,San Jose,1.0,1,1,0,434,135,569,135,0,434,0,1.0,0.0,1.0,0.0
467,2021,503113,Santa Clara County,San Jose,1.0,0,0,0,0,0,0,0,0,0,0,0.0,0.0,0.0,0.0
468,2022,503113,Santa Clara County,San Jose,1.0,6,0,6,6,0,6,0,0,0,6,0.0,1.0,0.0,0.0
469,2023,503113,Santa Clara County,San Jose,1.0,2,1,1,1,135,136,135,0,0,1,0.0,1.0,1.0,0.0
470,2024,503113,Santa Clara County,San Jose,1.0,5,0,5,0,5,5,0,5,0,0,0.0,0.0,0.0,1.0
471,All,503113,Santa Clara County,San Jose,1.0,14,2,12,441,275,716,270,5,434,7,1.0,1.0,1.0,1.0
472,2018,503116,Santa Clara County,San Jose,1.0,0,0,0,0,0,0,0,0,0,0,0.0,0.0,0.0,0.0
473,2019,503116,Santa Clara County,San Jose,1.0,0,0,0,0,0,0,0,0,0,0,0.0,0.0,0.0,0.0
474,2020,503116,Santa Clara County,San Jose,1.0,0,0,0,0,0,0,0,0,0,0,0.0,0.0,0.0,0.0
475,2021,503116,Santa Clara County,San Jose,1.0,0,0,0,0,0,0,0,0,0,0,0.0,0.0,0.0,0.0
476,2022,503116,Santa Clara County,San Jose,1.0,0,0,0,0,0,0,0,0,0,0,0.0,0.0,0.0,0.0
477,2023,503116,Santa Clara County,San Jose,1.0,0,0,0,0,0,0,0,0,0,0,0.0,0.0,0.0,0.0
478,2024,503116,Santa Clara County,San Jose,1.0,0,0,0,0,0,0,0,0,0,0,0.0,0.0,0.0,0.0
479,All,503116,Santa Clara County,San Jose,1.0,0,0,0,0,0,0,0,0,0,0,0.0,0.0,0.0,0.0
480,2018,503117,Santa Clara County,San Jose,1.0,0,0,0,0,0,0,0,0,0,0,0.0,0.0,0.0,0.0
481,2019,503117,Santa Clara County,San Jose,1.0,0,0,0,0,0,0,0,0,0,0,0.0,0.0,0.0,0.0
482,2020,503117,Santa Clara County,San Jose,1.0,0,0,0,0,0,0,0,0,0,0,0.0,0.0,0.0,0.0
483,2021,503117,Santa Clara County,San Jose,1.0,0,0,0,0,0,0,0,0,0,0,0.0,0.0,0.0,0.0
484,2022,503117,Santa Clara County,San Jose,1.0,1,0,1,1,0,1,0,0,0,1,0.0,1.0,0.0,0.0
485,2023,503117,Santa Clara County,San Jose,1.0,0,0,0,0,0,0,0,0,0,0,0.0,0.0,0.0,0.0
486,2024,503117,Santa Clara County,San Jose,1.0,3,0,3,0,3,3,0,3,0,0,0.0,0.0,0.0,1.0
487,All,503117,Santa Clara County,San Jose,1.0,4,0,4,1,3,4,0,3,0,1,0.0,1.0,0.0,1.0
488,2018,503118,Santa Clara County,San Jose,1.0,0,0,0,0,0,0,0,0,0,0,0.0,0.0,0.0,0.0
489,2019,503118,Santa Clara County,San Jose,1.0,0,0,0,0,0,0,0,0,0,0,0.0,0.0,0.0,0.0
490,2020,503118,Santa Clara County,San Jose,1.0,0,0,0,0,0,0,0,0,0,0,0.0,0.0,0.0,0.0
491,2021,503118,Santa Clara County,San Jose,1.0,0,0,0,0,0,0,0,0,0,0,0.0,0.0,0.0,0.0
492,2022,503118,Santa Clara County,San Jose,1.0,2,0,2,2,0,2,0,0,0,2,0.0,1.0,0.0,0.0
493,2023,503118,Santa Clara County,San Jose,1.0,3,0,3,3,0,3,0,0,0,3,0.0,1.0,0.0,0.0
494,2024,503118,Santa Clara County,San Jose,1.0,1,0,1,0,1,1,0,1,0,0,0.0,0.0,0.0,1.0
495,All,503118,Santa Clara County,San Jose,1.0,6,0,6,5,1,6,0,1,0,5,0.0,1.0,0.0,1.0
496,2018,503121,Santa Clara County,San Jose,1.0,0,0,0,0,0,0,0,0,0,0,0.0,0.0,0.0,0.0
497,2019,503121,Santa Clara County,San Jose,1.0,0,0,0,0,0,0,0,0,0,0,0.0,0.0,0.0,0.0
498,2020,503121,Santa Clara County,San Jose,1.0,0,0,0,0,0,0,0,0,0,0,0.0,0.0,0.0,0.0
499,2021,503121,Santa Clara County,San Jose,1.0,0,0,0,0,0,0,0,0,0,0,0.0,0.0,0.0,0.0
500,2022,503121,Santa Clara County,San Jose,1.0,5,0,5,5,0,5,0,0,0,5,0.0,1.0,0.0,0.0
501,2023,503121,Santa Clara County,San Jose,1.0,0,0,0,0,0,0,0,0,0,0,0.0,0.0,0.0,0.0
502,2024,503121,Santa Clara County,San Jose,1.0,6,0,6,0,6,6,0,6,0,0,0.0,0.0,0.0,1.0
503,All,503121,Santa Clara County,San Jose,1.0,11,0,11,5,6,11,0,6,0,5,0.0,1.0,0.0,1.0
504,2018,503122,Santa Clara County,San Jose,1.0,0,0,0,0,0,0,0,0,0,0,0.0,0.0,0.0,0.0
505,2019,503122,Santa Clara County,San Jose,1.0,1,0,1,815,0,815,0,0,0,815,0.0,0.0,0.0,0.0
506,2020,503122,Santa Clara County,San Jose,1.0,0,0,0,0,0,0,0,0,0,0,0.0,0.0,0.0,0.0
507,2021,503122,Santa Clara County,San Jose,1.0,0,0,0,0,0,0,0,0,0,0,0.0,0.0,0.0,0.0
508,2022,503122,Santa Clara County,San Jose,1.0,0,0,0,0,0,0,0,0,0,0,0.0,0.0,0.0,0.0
509,2023,503122,Santa Clara County,San Jose,1.0,0,0,0,0,0,0,0,0,0,0,0.0,0.0,0.0,0.0
510,2024,503122,Santa Clara County,San Jose,1.0,0,0,0,0,0,0,0,0,0,0,0.0,0.0,0.0,0.0
511,All,503122,Santa Clara County,San Jose,1.0,1,0,1,815,0,815,0,0,0,815,0.0,0.0,0.0,0.0
512,2018,503123,Santa Clara County,San Jose,1.0,0,0,0,0,0,0,0,0,0,0,0.0,0.0,0.0,0.0
513,2019,503123,Santa Clara County,San Jose,1.0,1,1,0,44,0,44,0,0,44,0,1.0,0.0,0.0,0.0
514,2020,503123,Santa Clara County,San Jose,1.0,1,1,0,62,9,71,9,0,62,0,0.0,0.0,0.0,0.0
515,2021,503123,Santa Clara County,San Jose,1.0,0,0,0,0,0,0,0,0,0,0,0.0,0.0,0.0,0.0
516,2022,503123,Santa Clara County,San Jose,1.0,1,0,1,1,0,1,0,0,0,1,0.0,1.0,0.0,0.0
517,2023,503123,Santa Clara County,San Jose,1.0,0,0,0,0,0,0,0,0,0,0,0.0,0.0,0.0,0.0
518,2024,503123,Santa Clara County,San Jose,1.0,2,2,0,27,6,33,6,0,27,0,0.0,0.0,1.0,0.0
519,All,503123,Santa Clara County,San Jose,1.0,5,4,1,134,15,149,15,0,133,1,0.3308270676691729,1.0,0.4,0.0
520,2018,503124,Santa Clara County,San Jose,1.0,1,1,0,6,0,6,0,0,6,0,0.0,0.0,0.0,0.0
521,2019,503124,Santa Clara County,San Jose,1.0,0,0,0,0,0,0,0,0,0,0,0.0,0.0,0.0,0.0
522,2020,503124,Santa Clara County,San Jose,1.0,0,0,0,0,0,0,0,0,0,0,0.0,0.0,0.0,0.0
523,2021,503124,Santa Clara County,San Jose,1.0,0,0,0,0,0,0,0,0,0,0,0.0,0.0,0.0,0.0
524,2022,503124,Santa Clara County,San Jose,1.0,1,0,1,1,0,1,0,0,0,1,0.0,1.0,0.0,0.0
525,2023,503124,Santa Clara County,San Jose,1.0,0,0,0,0,0,0,0,0,0,0,0.0,0.0,0.0,0.0
526,2024,503124,Santa Clara County,San Jose,1.0,0,0,0,0,0,0,0,0,0,0,0.0,0.0,0.0,0.0
527,All,503124,Santa Clara County,San Jose,1.0,2,1,1,7,0,7,0,0,6,1,0.0,1.0,0.0,0.0
528,2018,503125,Santa Clara County,San Jose,1.0,0,0,0,0,0,0,0,0,0,0,0.0,0.0,0.0,0.0
529,2019,503125,Santa Clara County,San Jose,1.0,0,0,0,0,0,0,0,0,0,0,0.0,0.0,0.0,0.0
530,2020,503125,Santa Clara County,San Jose,1.0,0,0,0,0,0,0,0,0,0,0,0.0,0.0,0.0,0.0
531,2021,503125,Santa Clara County,San Jose,1.0,0,0,0,0,0,0,0,0,0,0,0.0,0.0,0.0,0.0
532,2022,503125,Santa Clara County,San Jose,1.0,1,0,1,1,0,1,0,0,0,1,0.0,1.0,0.0,0.0
533,2023,503125,Santa Clara County,San Jose,1.0,0,0,0,0,0,0,0,0,0,0,0.0,0.0,0.0,0.0
534,2024,503125,Santa Clara County,San Jose,1.0,0,0,0,0,0,0,0,0,0,0,0.0,0.0,0.0,0.0
535,All,503125,Santa Clara County,San Jose,1.0,1,0,1,1,0,1,0,0,0,1,0.0,1.0,0.0,0.0
536,2018,503126,Santa Clara County,San Jose,1.0,0,0,0,0,0,0,0,0,0,0,0.0,0.0,0.0,0.0
537,2019,503126,Santa Clara County,San Jose,1.0,0,0,0,0,0,0,0,0,0,0,0.0,0.0,0.0,0.0
538,2020,503126,Santa Clara County,San Jose,1.0,0,0,0,0,0,0,0,0,0,0,0.0,0.0,0.0,0.0
539,2021,503126,Santa Clara County,San Jose,1.0,0,0,0,0,0,0,0,0,0,0,0.0,0.0,0.0,0.0
540,2022,503126,Santa Clara County,San Jose,1.0,1,0,1,10,0,10,0,0,0,10,0.0,0.0,0.0,0.0
541,2023,503126,Santa Clara County,San Jose,1.0,0,0,0,0,0,0,0,0,0,0,0.0,0.0,0.0,0.0
542,2024,503126,Santa Clara County,San Jose,1.0,0,0,0,0,0,0,0,0,0,0,0.0,0.0,0.0,0.0
543,All,503126,Santa Clara County,San Jose,1.0,1,0,1,10,0,10,0,0,0,10,0.0,0.0,0.0,0.0
544,2018,503127,Santa Clara County,San Jose,0.951,0,0,0,0,0,0,0,0,0,0,0.0,0.0,0.0,0.0
545,2019,503127,Santa Clara County,San Jose,0.951,0,0,0,0,0,0,0,0,0,0,0.0,0.0,0.0,0.0
546,2020,503127,Santa Clara County,San Jose,0.951,0,0,0,0,0,0,0,0,0,0,0.0,0.0,0.0,0.0
547,2021,503127,Santa Clara County,San Jose,0.951,0,0,0,0,0,0,0,0,0,0,0.0,0.0,0.0,0.0
548,2022,503127,Santa Clara County,San Jose,0.951,0,0,0,0,0,0,0,0,0,0,0.0,0.0,0.0,0.0
549,2023,503127,Santa Clara County,San Jose,0.951,0,0,0,0,0,0,0,0,0,0,0.0,0.0,0.0,0.0
550,2024,503127,Santa Clara County,San Jose,0.951,0,0,0,0,0,0,0,0,0,0,0.0,0.0,0.0,0.0
551,All,503127,Santa Clara County,San Jose,0.951,0,0,0,0,0,0,0,0,0,0,0.0,0.0,0.0,0.0
552,2018,503207,Santa Clara County,San Jose,0.887,0,0,0,0,0,0,0,0,0,0,0.0,0.0,0.0,0.0
553,2019,503207,Santa Clara County,San Jose,0.887,0,0,0,0,0,0,0,0,0,0,0.0,0.0,0.0,0.0
554,2020,503207,Santa Clara County,San Jose,0.887,0,0,0,0,0,0,0,0,0,0,0.0,0.0,0.0,0.0
555,2021,503207,Santa Clara County,San Jose,0.887,0,0,0,0,0,0,0,0,0,0,0.0,0.0,0.0,0.0
556,2022,503207,Santa Clara County,San Jose,0.887,5,0,5,5,0,5,0,0,0,5,0.0,1.0,0.0,0.0
557,2023,503207,Santa Clara County,San Jose,0.887,10,0,10,10,0,10,0,0,0,10,0.0,1.0,0.0,0.0
558,2024,503207,Santa Clara County,San Jose,0.887,7,0,7,0,7,7,0,7,0,0,0.0,0.0,0.0,1.0
559,All,503207,Santa Clara County,San Jose,0.887,22,0,22,15,7,22,0,7,0,15,0.0,1.0,0.0,1.0
560,2018,503208,Santa Clara County,San Jose,0.721,0,0,0,0,0,0,0,0,0,0,0.0,0.0,0.0,0.0
561,2019,503208,Santa Clara County,San Jose,0.721,0,0,0,0,0,0,0,0,0,0,0.0,0.0,0.0,0.0
562,2020,503208,Santa Clara County,San Jose,0.721,0,0,0,0,0,0,0,0,0,0,0.0,0.0,0.0,0.0
563,2021,503208,Santa Clara County,San Jose,0.721,0,0,0,0,0,0,0,0,0,0,0.0,0.0,0.0,0.0
564,2022,503208,Santa Clara County,San Jose,0.721,1,0,1,1,0,1,0,0,0,1,0.0,1.0,0.0,0.0
565,2023,503208,Santa Clara County,San Jose,0.721,3,0,3,3,0,3,0,0,0,3,0.0,1.0,0.0,0.0
566,2024,503208,Santa Clara County,San Jose,0.721,3,0,3,0,3,3,0,3,0,0,0.0,0.0,0.0,1.0
567,All,503208,Santa Clara County,San Jose,0.721,7,0,7,4,3,7,0,3,0,4,0.0,1.0,0.0,1.0
568,2018,503210,Santa Clara County,San Jose,0.928,0,0,0,0,0,0,0,0,0,0,0.0,0.0,0.0,0.0
569,2019,503210,Santa Clara County,San Jose,0.928,0,0,0,0,0,0,0,0,0,0,0.0,0.0,0.0,0.0
570,2020,503210,Santa Clara County,San Jose,0.928,0,0,0,0,0,0,0,0,0,0,0.0,0.0,0.0,0.0
571,2021,503210,Santa Clara County,San Jose,0.928,0,0,0,0,0,0,0,0,0,0,0.0,0.0,0.0,0.0
572,2022,503210,Santa Clara County,San Jose,0.928,5,0,5,5,0,5,0,0,0,5,0.0,1.0,0.0,0.0
573,2023,503210,Santa Clara County,San Jose,0.928,15,0,15,15,0,15,0,0,0,15,0.0,0.8,0.0,0.0
574,2024,503210,Santa Clara County,San Jose,0.928,5,0,5,0,5,5,0,5,0,0,0.0,0.0,0.0,1.0
575,All,503210,Santa Clara County,San Jose,0.928,25,0,25,20,5,25,0,5,0,20,0.0,0.85,0.0,1.0
576,2018,503211,Santa Clara County,San Jose,1.0,0,0,0,0,0,0,0,0,0,0,0.0,0.0,0.0,0.0
577,2019,503211,Santa Clara County,San Jose,1.0,0,0,0,0,0,0,0,0,0,0,0.0,0.0,0.0,0.0
578,2020,503211,Santa Clara County,San Jose,1.0,0,0,0,0,0,0,0,0,0,0,0.0,0.0,0.0,0.0
579,2021,503211,Santa Clara County,San Jose,1.0,0,0,0,0,0,0,0,0,0,0,0.0,0.0,0.0,0.0
580,2022,503211,Santa Clara County,San Jose,1.0,3,0,3,3,0,3,0,0,0,3,0.0,1.0,0.0,0.0
581,2023,503211,Santa Clara County,San Jose,1.0,4,0,4,4,0,4,0,0,0,4,0.0,1.0,0.0,0.0
582,2024,503211,Santa Clara County,San Jose,1.0,4,0,4,6,3,9,0,3,0,6,0.0,0.0,0.0,1.0
583,All,503211,Santa Clara County,San Jose,1.0,11,0,11,13,3,16,0,3,0,13,0.0,0.5384615384615384,0.0,1.0
584,2018,503212,Santa Clara County,San Jose,1.0,0,0,0,0,0,0,0,0,0,0,0.0,0.0,0.0,0.0
585,2019,503212,Santa Clara County,San Jose,1.0,0,0,0,0,0,0,0,0,0,0,0.0,0.0,0.0,0.0
586,2020,503212,Santa Clara County,San Jose,1.0,0,0,0,0,0,0,0,0,0,0,0.0,0.0,0.0,0.0
587,2021,503212,Santa Clara County,San Jose,1.0,0,0,0,0,0,0,0,0,0,0,0.0,0.0,0.0,0.0
588,2022,503212,Santa Clara County,San Jose,1.0,5,0,5,5,0,5,0,0,0,5,0.0,1.0,0.0,0.0
589,2023,503212,Santa Clara County,San Jose,1.0,9,0,9,9,0,9,0,0,0,9,0.0,1.0,0.0,0.0
590,2024,503212,Santa Clara County,San Jose,1.0,5,0,5,0,5,5,0,5,0,0,0.0,0.0,0.0,1.0
591,All,503212,Santa Clara County,San Jose,1.0,19,0,19,14,5,19,0,5,0,14,0.0,1.0,0.0,1.0
592,2018,503213,Santa Clara County,San Jose,1.0,0,0,0,0,0,0,0,0,0,0,0.0,0.0,0.0,0.0
593,2019,503213,Santa Clara County,San Jose,1.0,0,0,0,0,0,0,0,0,0,0,0.0,0.0,0.0,0.0
594,2020,503213,Santa Clara County,San Jose,1.0,0,0,0,0,0,0,0,0,0,0,0.0,0.0,0.0,0.0
595,2021,503213,Santa Clara County,San Jose,1.0,0,0,0,0,0,0,0,0,0,0,0.0,0.0,0.0,0.0
596,2022,503213,Santa Clara County,San Jose,1.0,3,0,3,3,0,3,0,0,0,3,0.0,1.0,0.0,0.0
597,2023,503213,Santa Clara County,San Jose,1.0,3,0,3,3,0,3,0,0,0,3,0.0,1.0,0.0,0.0
598,2024,503213,Santa Clara County,San Jose,1.0,2,0,2,0,2,2,0,2,0,0,0.0,0.0,0.0,1.0
599,All,503213,Santa Clara County,San Jose,1.0,8,0,8,6,2,8,0,2,0,6,0.0,1.0,0.0,1.0
600,2018,503217,Santa Clara County,San Jose,1.0,0,0,0,0,0,0,0,0,0,0,0.0,0.0,0.0,0.0
601,2019,503217,Santa Clara County,San Jose,1.0,0,0,0,0,0,0,0,0,0,0,0.0,0.0,0.0,0.0
602,2020,503217,Santa Clara County,San Jose,1.0,0,0,0,0,0,0,0,0,0,0,0.0,0.0,0.0,0.0
603,2021,503217,Santa Clara County,San Jose,1.0,0,0,0,0,0,0,0,0,0,0,0.0,0.0,0.0,0.0
604,2022,503217,Santa Clara County,San Jose,1.0,2,0,2,2,0,2,0,0,0,2,0.0,1.0,0.0,0.0
605,2023,503217,Santa Clara County,San Jose,1.0,2,0,2,2,0,2,0,0,0,2,0.0,1.0,0.0,0.0
606,2024,503217,Santa Clara County,San Jose,1.0,5,0,5,0,5,5,0,5,0,0,0.0,0.0,0.0,1.0
607,All,503217,Santa Clara County,San Jose,1.0,9,0,9,4,5,9,0,5,0,4,0.0,1.0,0.0,1.0
608,2018,503218,Santa Clara County,San Jose,1.0,0,0,0,0,0,0,0,0,0,0,0.0,0.0,0.0,0.0
609,2019,503218,Santa Clara County,San Jose,1.0,0,0,0,0,0,0,0,0,0,0,0.0,0.0,0.0,0.0
610,2020,503218,Santa Clara County,San Jose,1.0,0,0,0,0,0,0,0,0,0,0,0.0,0.0,0.0,0.0
611,2021,503218,Santa Clara County,San Jose,1.0,0,0,0,0,0,0,0,0,0,0,0.0,0.0,0.0,0.0
612,2022,503218,Santa Clara County,San Jose,1.0,4,0,4,4,0,4,0,0,0,4,0.0,1.0,0.0,0.0
613,2023,503218,Santa Clara County,San Jose,1.0,0,0,0,0,0,0,0,0,0,0,0.0,0.0,0.0,0.0
614,2024,503218,Santa Clara County,San Jose,1.0,5,0,5,2,3,5,0,3,0,2,0.0,1.0,0.0,1.0
615,All,503218,Santa Clara County,San Jose,1.0,9,0,9,6,3,9,0,3,0,6,0.0,1.0,0.0,1.0
616,2018,503219,Santa Clara County,San Jose,1.0,0,0,0,0,0,0,0,0,0,0,0.0,0.0,0.0,0.0
617,2019,503219,Santa Clara County,San Jose,1.0,0,0,0,0,0,0,0,0,0,0,0.0,0.0,0.0,0.0
618,2020,503219,Santa Clara County,San Jose,1.0,0,0,0,0,0,0,0,0,0,0,0.0,0.0,0.0,0.0
619,2021,503219,Santa Clara County,San Jose,1.0,0,0,0,0,0,0,0,0,0,0,0.0,0.0,0.0,0.0
620,2022,503219,Santa Clara County,San Jose,1.0,4,0,4,4,0,4,0,0,0,4,0.0,1.0,0.0,0.0
621,2023,503219,Santa Clara County,San Jose,1.0,2,0,2,2,0,2,0,0,0,2,0.0,1.0,0.0,0.0
622,2024,503219,Santa Clara County,San Jose,1.0,2,0,2,0,2,2,0,2,0,0,0.0,0.0,0.0,1.0
623,All,503219,Santa Clara County,San Jose,1.0,8,0,8,6,2,8,0,2,0,6,0.0,1.0,0.0,1.0
624,2018,503220,Santa Clara County,San Jose,1.0,0,0,0,0,0,0,0,0,0,0,0.0,0.0,0.0,0.0
625,2019,503220,Santa Clara County,San Jose,1.0,0,0,0,0,0,0,0,0,0,0,0.0,0.0,0.0,0.0
626,2020,503220,Santa Clara County,San Jose,1.0,2,1,1,16,0,16,0,0,14,2,1.0,0.0,0.0,0.0
627,2021,503220,Santa Clara County,San Jose,1.0,0,0,0,0,0,0,0,0,0,0,0.0,0.0,0.0,0.0
628,2022,503220,Santa Clara County,San Jose,1.0,4,0,4,4,0,4,0,0,0,4,0.0,1.0,0.0,0.0
629,2023,503220,Santa Clara County,San Jose,1.0,7,0,7,12,0,12,0,0,0,12,0.0,0.5,0.0,0.0
630,2024,503220,Santa Clara County,San Jose,1.0,13,1,12,7,9,16,0,9,2,5,1.0,0.2,0.0,1.0
631,All,503220,Santa Clara County,San Jose,1.0,26,2,24,39,9,48,0,9,16,23,1.0,0.4782608695652174,0.0,1.0
632,2018,503221,Santa Clara County,San Jose,0.409,0,0,0,0,0,0,0,0,0,0,0.0,0.0,0.0,0.0
633,2019,503221,Santa Clara County,San Jose,0.409,0,0,0,0,0,0,0,0,0,0,0.0,0.0,0.0,0.0
634,2020,503221,Santa Clara County,San Jose,0.409,0,0,0,0,0,0,0,0,0,0,0.0,0.0,0.0,0.0
635,2021,503221,Santa Clara County,San Jose,0.409,0,0,0,0,0,0,0,0,0,0,0.0,0.0,0.0,0.0
636,2022,503221,Santa Clara County,San Jose,0.409,0,0,0,0,0,0,0,0,0,0,0.0,0.0,0.0,0.0
637,2023,503221,Santa Clara County,San Jose,0.409,1,0,1,1,0,1,0,0,0,1,0.0,1.0,0.0,0.0
638,2024,503221,Santa Clara County,San Jose,0.409,4,0,4,0,4,4,0,4,0,0,0.0,0.0,0.0,1.0
639,All,503221,Santa Clara County,San Jose,0.409,5,0,5,1,4,5,0,4,0,1,0.0,1.0,0.0,1.0
640,2018,503222,Santa Clara County,San Jose,1.0,0,0,0,0,0,0,0,0,0,0,0.0,0.0,0.0,0.0
641,2019,503222,Santa Clara County,San Jose,1.0,0,0,0,0,0,0,0,0,0,0,0.0,0.0,0.0,0.0
642,2020,503222,Santa Clara County,San Jose,1.0,0,0,0,0,0,0,0,0,0,0,0.0,0.0,0.0,0.0
643,2021,503222,Santa Clara County,San Jose,1.0,0,0,0,0,0,0,0,0,0,0,0.0,0.0,0.0,0.0
644,2022,503222,Santa Clara County,San Jose,1.0,0,0,0,0,0,0,0,0,0,0,0.0,0.0,0.0,0.0
645,2023,503222,Santa Clara County,San Jose,1.0,1,0,1,1,0,1,0,0,0,1,0.0,1.0,0.0,0.0
646,2024,503222,Santa Clara County,San Jose,1.0,1,0,1,0,1,1,0,1,0,0,0.0,0.0,0.0,1.0
647,All,503222,Santa Clara County,San Jose,1.0,2,0,2,1,1,2,0,1,0,1,0.0,1.0,0.0,1.0
648,2018,503304,Santa Clara County,San Jose,1.0,0,0,0,0,0,0,0,0,0,0,0.0,0.0,0.0,0.0
649,2019,503304,Santa Clara County,San Jose,1.0,0,0,0,0,0,0,0,0,0,0,0.0,0.0,0.0,0.0
650,2020,503304,Santa Clara County,San Jose,1.0,0,0,0,0,0,0,0,0,0,0,0.0,0.0,0.0,0.0
651,2021,503304,Santa Clara County,San Jose,1.0,0,0,0,0,0,0,0,0,0,0,0.0,0.0,0.0,0.0
652,2022,503304,Santa Clara County,San Jose,1.0,5,0,5,5,0,5,0,0,0,5,0.0,1.0,0.0,0.0
653,2023,503304,Santa Clara County,San Jose,1.0,4,0,4,4,0,4,0,0,0,4,0.0,1.0,0.0,0.0
654,2024,503304,Santa Clara County,San Jose,1.0,3,0,3,0,3,3,0,3,0,0,0.0,0.0,0.0,1.0
655,All,503304,Santa Clara County,San Jose,1.0,12,0,12,9,3,12,0,3,0,9,0.0,1.0,0.0,1.0
656,2018,503305,Santa Clara County,San Jose,1.0,0,0,0,0,0,0,0,0,0,0,0.0,0.0,0.0,0.0
657,2019,503305,Santa Clara County,San Jose,1.0,0,0,0,0,0,0,0,0,0,0,0.0,0.0,0.0,0.0
658,2020,503305,Santa Clara County,San Jose,1.0,0,0,0,0,0,0,0,0,0,0,0.0,0.0,0.0,0.0
659,2021,503305,Santa Clara County,San Jose,1.0,0,0,0,0,0,0,0,0,0,0,0.0,0.0,0.0,0.0
660,2022,503305,Santa Clara County,San Jose,1.0,4,0,4,4,0,4,0,0,0,4,0.0,1.0,0.0,0.0
661,2023,503305,Santa Clara County,San Jose,1.0,7,0,7,7,0,7,0,0,0,7,0.0,1.0,0.0,0.0
662,2024,503305,Santa Clara County,San Jose,1.0,3,0,3,0,3,3,0,3,0,0,0.0,0.0,0.0,1.0
663,All,503305,Santa Clara County,San Jose,1.0,14,0,14,11,3,14,0,3,0,11,0.0,1.0,0.0,1.0
664,2018,503306,Santa Clara County,San Jose,1.0,0,0,0,0,0,0,0,0,0,0,0.0,0.0,0.0,0.0
665,2019,503306,Santa Clara County,San Jose,1.0,0,0,0,0,0,0,0,0,0,0,0.0,0.0,0.0,0.0
666,2020,503306,Santa Clara County,San Jose,1.0,0,0,0,0,0,0,0,0,0,0,0.0,0.0,0.0,0.0
667,2021,503306,Santa Clara County,San Jose,1.0,0,0,0,0,0,0,0,0,0,0,0.0,0.0,0.0,0.0
668,2022,503306,Santa Clara County,San Jose,1.0,5,0,5,5,0,5,0,0,0,5,0.0,1.0,0.0,0.0
669,2023,503306,Santa Clara County,San Jose,1.0,3,0,3,3,0,3,0,0,0,3,0.0,1.0,0.0,0.0
670,2024,503306,Santa Clara County,San Jose,1.0,1,0,1,0,1,1,0,1,0,0,0.0,0.0,0.0,1.0
671,All,503306,Santa Clara County,San Jose,1.0,9,0,9,8,1,9,0,1,0,8,0.0,1.0,0.0,1.0
672,2018,503312,Santa Clara County,San Jose,0.069,0,0,0,0,0,0,0,0,0,0,0.0,0.0,0.0,0.0
673,2019,503312,Santa Clara County,San Jose,0.069,0,0,0,0,0,0,0,0,0,0,0.0,0.0,0.0,0.0
674,2020,503312,Santa Clara County,San Jose,0.069,0,0,0,0,0,0,0,0,0,0,0.0,0.0,0.0,0.0
675,2021,503312,Santa Clara County,San Jose,0.069,0,0,0,0,0,0,0,0,0,0,0.0,0.0,0.0,0.0
676,2022,503312,Santa Clara County,San Jose,0.069,4,0,4,4,0,4,0,0,0,4,0.0,1.0,0.0,0.0
677,2023,503312,Santa Clara County,San Jose,0.069,1,0,1,1,0,1,0,0,0,1,0.0,1.0,0.0,0.0
678,2024,503312,Santa Clara County,San Jose,0.069,2,0,2,0,2,2,0,2,0,0,0.0,0.0,0.0,1.0
679,All,503312,Santa Clara County,San Jose,0.069,7,0,7,5,2,7,0,2,0,5,0.0,1.0,0.0,1.0
680,2018,503313,Santa Clara County,San Jose,1.0,0,0,0,0,0,0,0,0,0,0,0.0,0.0,0.0,0.0
681,2019,503313,Santa Clara County,San Jose,1.0,0,0,0,0,0,0,0,0,0,0,0.0,0.0,0.0,0.0
682,2020,503313,Santa Clara County,San Jose,1.0,0,0,0,0,0,0,0,0,0,0,0.0,0.0,0.0,0.0
683,2021,503313,Santa Clara County,San Jose,1.0,0,0,0,0,0,0,0,0,0,0,0.0,0.0,0.0,0.0
684,2022,503313,Santa Clara County,San Jose,1.0,6,0,6,6,0,6,0,0,0,6,0.0,1.0,0.0,0.0
685,2023,503313,Santa Clara County,San Jose,1.0,2,0,2,2,0,2,0,0,0,2,0.0,1.0,0.0,0.0
686,2024,503313,Santa Clara County,San Jose,1.0,1,0,1,0,1,1,0,1,0,0,0.0,0.0,0.0,1.0
687,All,503313,Santa Clara County,San Jose,1.0,9,0,9,8,1,9,0,1,0,8,0.0,1.0,0.0,1.0
688,2018,503315,Santa Clara County,San Jose,1.0,0,0,0,0,0,0,0,0,0,0,0.0,0.0,0.0,0.0
689,2019,503315,Santa Clara County,San Jose,1.0,0,0,0,0,0,0,0,0,0,0,0.0,0.0,0.0,0.0
690,2020,503315,Santa Clara County,San Jose,1.0,0,0,0,0,0,0,0,0,0,0,0.0,0.0,0.0,0.0
691,2021,503315,Santa Clara County,San Jose,1.0,0,0,0,0,0,0,0,0,0,0,0.0,0.0,0.0,0.0
692,2022,503315,Santa Clara County,San Jose,1.0,4,0,4,4,0,4,0,0,0,4,0.0,1.0,0.0,0.0
693,2023,503315,Santa Clara County,San Jose,1.0,5,0,5,5,0,5,0,0,0,5,0.0,1.0,0.0,0.0
694,2024,503315,Santa Clara County,San Jose,1.0,3,0,3,0,3,3,0,3,0,0,0.0,0.0,0.0,1.0
695,All,503315,Santa Clara County,San Jose,1.0,12,0,12,9,3,12,0,3,0,9,0.0,1.0,0.0,1.0
696,2018,503321,Santa Clara County,San Jose,1.0,0,0,0,0,0,0,0,0,0,0,0.0,0.0,0.0,0.0
697,2019,503321,Santa Clara County,San Jose,1.0,0,0,0,0,0,0,0,0,0,0,0.0,0.0,0.0,0.0
698,2020,503321,Santa Clara County,San Jose,1.0,0,0,0,0,0,0,0,0,0,0,0.0,0.0,0.0,0.0
699,2021,503321,Santa Clara County,San Jose,1.0,0,0,0,0,0,0,0,0,0,0,0.0,0.0,0.0,0.0
700,2022,503321,Santa Clara County,San Jose,1.0,0,0,0,0,0,0,0,0,0,0,0.0,0.0,0.0,0.0
701,2023,503321,Santa Clara County,San Jose,1.0,1,0,1,8,0,8,0,0,0,8,0.0,0.0,0.0,0.0
702,2024,503321,Santa Clara County,San Jose,1.0,3,0,3,1,2,3,0,2,0,1,0.0,1.0,0.0,1.0
703,All,503321,Santa Clara County,San Jose,1.0,4,0,4,9,2,11,0,2,0,9,0.0,0.1111111111111111,0.0,1.0
704,2018,503322,Santa Clara County,San Jose,0.698,0,0,0,0,0,0,0,0,0,0,0.0,0.0,0.0,0.0
705,2019,503322,Santa Clara County,San Jose,0.698,0,0,0,0,0,0,0,0,0,0,0.0,0.0,0.0,0.0
706,2020,503322,Santa Clara County,San Jose,0.698,0,0,0,0,0,0,0,0,0,0,0.0,0.0,0.0,0.0
707,2021,503322,Santa Clara County,San Jose,0.698,0,0,0,0,0,0,0,0,0,0,0.0,0.0,0.0,0.0
708,2022,503322,Santa Clara County,San Jose,0.698,8,0,8,8,0,8,0,0,0,8,0.0,1.0,0.0,0.0
709,2023,503322,Santa Clara County,San Jose,0.698,1,0,1,1,0,1,0,0,0,1,0.0,1.0,0.0,0.0
710,2024,503322,Santa Clara County,San Jose,0.698,1,0,1,0,1,1,0,1,0,0,0.0,0.0,0.0,1.0
711,All,503322,Santa Clara County,San Jose,0.698,10,0,10,9,1,10,0,1,0,9,0.0,1.0,0.0,1.0
712,2018,503323,Santa Clara County,San Jose,1.0,0,0,0,0,0,0,0,0,0,0,0.0,0.0,0.0,0.0
713,2019,503323,Santa Clara County,San Jose,1.0,0,0,0,0,0,0,0,0,0,0,0.0,0.0,0.0,0.0
714,2020,503323,Santa Clara County,San Jose,1.0,0,0,0,0,0,0,0,0,0,0,0.0,0.0,0.0,0.0
715,2021,503323,Santa Clara County,San Jose,1.0,0,0,0,0,0,0,0,0,0,0,0.0,0.0,0.0,0.0
716,2022,503323,Santa Clara County,San Jose,1.0,3,0,3,3,0,3,0,0,0,3,0.0,1.0,0.0,0.0
717,2023,503323,Santa Clara County,San Jose,1.0,5,0,5,5,0,5,0,0,0,5,0.0,1.0,0.0,0.0
718,2024,503323,Santa Clara County,San Jose,1.0,5,0,5,0,5,5,0,5,0,0,0.0,0.0,0.0,1.0
719,All,503323,Santa Clara County,San Jose,1.0,13,0,13,8,5,13,0,5,0,8,0.0,1.0,0.0,1.0
720,2018,503324,Santa Clara County,San Jose,1.0,0,0,0,0,0,0,0,0,0,0,0.0,0.0,0.0,0.0
721,2019,503324,Santa Clara County,San Jose,1.0,0,0,0,0,0,0,0,0,0,0,0.0,0.0,0.0,0.0
722,2020,503324,Santa Clara County,San Jose,1.0,0,0,0,0,0,0,0,0,0,0,0.0,0.0,0.0,0.0
723,2021,503324,Santa Clara County,San Jose,1.0,0,0,0,0,0,0,0,0,0,0,0.0,0.0,0.0,0.0
724,2022,503324,Santa Clara County,San Jose,1.0,3,0,3,3,0,3,0,0,0,3,0.0,0.6666666666666666,0.0,0.0
725,2023,503324,Santa Clara County,San Jose,1.0,8,0,8,8,0,8,0,0,0,8,0.0,0.625,0.0,0.0
726,2024,503324,Santa Clara County,San Jose,1.0,1,0,1,0,1,1,0,1,0,0,0.0,0.0,0.0,1.0
727,All,503324,Santa Clara County,San Jose,1.0,12,0,12,11,1,12,0,1,0,11,0.0,0.6363636363636364,0.0,1.0
728,2018,503325,Santa Clara County,San Jose,1.0,0,0,0,0,0,0,0,0,0,0,0.0,0.0,0.0,0.0
729,2019,503325,Santa Clara County,San Jose,1.0,0,0,0,0,0,0,0,0,0,0,0.0,0.0,0.0,0.0
730,2020,503325,Santa Clara County,San Jose,1.0,0,0,0,0,0,0,0,0,0,0,0.0,0.0,0.0,0.0
731,2021,503325,Santa Clara County,San Jose,1.0,0,0,0,0,0,0,0,0,0,0,0.0,0.0,0.0,0.0
732,2022,503325,Santa Clara County,San Jose,1.0,4,0,4,4,0,4,0,0,0,4,0.0,1.0,0.0,0.0
733,2023,503325,Santa Clara County,San Jose,1.0,5,0,5,5,0,5,0,0,0,5,0.0,1.0,0.0,0.0
734,2024,503325,Santa Clara County,San Jose,1.0,2,0,2,0,2,2,0,2,0,0,0.0,0.0,0.0,1.0
735,All,503325,Santa Clara County,San Jose,1.0,11,0,11,9,2,11,0,2,0,9,0.0,1.0,0.0,1.0
736,2018,503326,Santa Clara County,San Jose,0.527,0,0,0,0,0,0,0,0,0,0,0.0,0.0,0.0,0.0
737,2019,503326,Santa Clara County,San Jose,0.527,0,0,0,0,0,0,0,0,0,0,0.0,0.0,0.0,0.0
738,2020,503326,Santa Clara County,San Jose,0.527,0,0,0,0,0,0,0,0,0,0,0.0,0.0,0.0,0.0
739,2021,503326,Santa Clara County,San Jose,0.527,0,0,0,0,0,0,0,0,0,0,0.0,0.0,0.0,0.0
740,2022,503326,Santa Clara County,San Jose,0.527,3,0,3,3,0,3,0,0,0,3,0.0,1.0,0.0,0.0
741,2023,503326,Santa Clara County,San Jose,0.527,2,0,2,2,0,2,0,0,0,2,0.0,1.0,0.0,0.0
742,2024,503326,Santa Clara County,San Jose,0.527,0,0,0,0,0,0,0,0,0,0,0.0,0.0,0.0,0.0
743,All,503326,Santa Clara County,San Jose,0.527,5,0,5,5,0,5,0,0,0,5,0.0,1.0,0.0,0.0
744,2018,503327,Santa Clara County,San Jose,1.0,0,0,0,0,0,0,0,0,0,0,0.0,0.0,0.0,0.0
745,2019,503327,Santa Clara County,San Jose,1.0,1,0,1,2,0,2,0,0,0,2,0.0,0.0,0.0,0.0
746,2020,503327,Santa Clara County,San Jose,1.0,0,0,0,0,0,0,0,0,0,0,0.0,0.0,0.0,0.0
747,2021,503327,Santa Clara County,San Jose,1.0,0,0,0,0,0,0,0,0,0,0,0.0,0.0,0.0,0.0
748,2022,503327,Santa Clara County,San Jose,1.0,2,0,2,2,0,2,0,0,0,2,0.0,1.0,0.0,0.0
749,2023,503327,Santa Clara County,San Jose,1.0,8,0,8,8,0,8,0,0,0,8,0.0,0.875,0.0,0.0
750,2024,503327,Santa Clara County,San Jose,1.0,5,0,5,1,4,5,0,4,0,1,0.0,1.0,0.0,1.0
751,All,503327,Santa Clara County,San Jose,1.0,16,0,16,13,4,17,0,4,0,13,0.0,0.7692307692307693,0.0,1.0
752,2018,503329,Santa Clara County,San Jose,1.0,0,0,0,0,0,0,0,0,0,0,0.0,0.0,0.0,0.0
753,2019,503329,Santa Clara County,San Jose,1.0,0,0,0,0,0,0,0,0,0,0,0.0,0.0,0.0,0.0
754,2020,503329,Santa Clara County,San Jose,1.0,0,0,0,0,0,0,0,0,0,0,0.0,0.0,0.0,0.0
755,2021,503329,Santa Clara County,San Jose,1.0,0,0,0,0,0,0,0,0,0,0,0.0,0.0,0.0,0.0
756,2022,503329,Santa Clara County,San Jose,1.0,1,0,1,1,0,1,0,0,0,1,0.0,1.0,0.0,0.0
757,2023,503329,Santa Clara County,San Jose,1.0,4,0,4,4,0,4,0,0,0,4,0.0,1.0,0.0,0.0
758,2024,503329,Santa Clara County,San Jose,1.0,2,0,2,0,2,2,0,2,0,0,0.0,0.0,0.0,1.0
759,All,503329,Santa Clara County,San Jose,1.0,7,0,7,5,2,7,0,2,0,5,0.0,1.0,0.0,1.0
760,2018,503330,Santa Clara County,San Jose,0.354,0,0,0,0,0,0,0,0,0,0,0.0,0.0,0.0,0.0
761,2019,503330,Santa Clara County,San Jose,0.354,0,0,0,0,0,0,0,0,0,0,0.0,0.0,0.0,0.0
762,2020,503330,Santa Clara County,San Jose,0.354,0,0,0,0,0,0,0,0,0,0,0.0,0.0,0.0,0.0
763,2021,503330,Santa Clara County,San Jose,0.354,0,0,0,0,0,0,0,0,0,0,0.0,0.0,0.0,0.0
764,2022,503330,Santa Clara County,San Jose,0.354,1,0,1,1,0,1,0,0,0,1,0.0,1.0,0.0,0.0
765,2023,503330,Santa Clara County,San Jose,0.354,0,0,0,0,0,0,0,0,0,0,0.0,0.0,0.0,0.0
766,2024,503330,Santa Clara County,San Jose,0.354,3,0,3,2,1,3,0,1,0,2,0.0,0.5,0.0,1.0
767,All,503330,Santa Clara County,San Jose,0.354,4,0,4,3,1,4,0,1,0,3,0.0,0.6666666666666666,0.0,1.0
768,2018,503331,Santa Clara County,San Jose,0.971,0,0,0,0,0,0,0,0,0,0,0.0,0.0,0.0,0.0
769,2019,503331,Santa Clara County,San Jose,0.971,0,0,0,0,0,0,0,0,0,0,0.0,0.0,0.0,0.0
770,2020,503331,Santa Clara County,San Jose,0.971,0,0,0,0,0,0,0,0,0,0,0.0,0.0,0.0,0.0
771,2021,503331,Santa Clara County,San Jose,0.971,0,0,0,0,0,0,0,0,0,0,0.0,0.0,0.0,0.0
772,2022,503331,Santa Clara County,San Jose,0.971,0,0,0,0,0,0,0,0,0,0,0.0,0.0,0.0,0.0
773,2023,503331,Santa Clara County,San Jose,0.971,1,0,1,1,0,1,0,0,0,1,0.0,1.0,0.0,0.0
774,2024,503331,Santa Clara County,San Jose,0.971,1,0,1,0,1,1,0,1,0,0,0.0,0.0,0.0,1.0
775,All,503331,Santa Clara County,San Jose,0.971,2,0,2,1,1,2,0,1,0,1,0.0,1.0,0.0,1.0
776,2018,503332,Santa Clara County,San Jose,0.671,2,0,2,2,0,2,0,0,0,2,0.0,0.0,0.0,0.0
777,2019,503332,Santa Clara County,San Jose,0.671,1,0,1,1,0,1,0,0,0,1,0.0,0.0,0.0,0.0
778,2020,503332,Santa Clara County,San Jose,0.671,0,0,0,0,0,0,0,0,0,0,0.0,0.0,0.0,0.0
779,2021,503332,Santa Clara County,San Jose,0.671,0,0,0,0,0,0,0,0,0,0,0.0,0.0,0.0,0.0
780,2022,503332,Santa Clara County,San Jose,0.671,3,0,3,3,0,3,0,0,0,3,0.0,1.0,0.0,0.0
781,2023,503332,Santa Clara County,San Jose,0.671,2,0,2,2,0,2,0,0,0,2,0.0,0.5,0.0,0.0
782,2024,503332,Santa Clara County,San Jose,0.671,5,0,5,0,5,5,0,5,0,0,0.0,0.0,0.0,1.0
783,All,503332,Santa Clara County,San Jose,0.671,13,0,13,8,5,13,0,5,0,8,0.0,0.5,0.0,1.0
784,2018,503333,Santa Clara County,San Jose,1.0,0,0,0,0,0,0,0,0,0,0,0.0,0.0,0.0,0.0
785,2019,503333,Santa Clara County,San Jose,1.0,0,0,0,0,0,0,0,0,0,0,0.0,0.0,0.0,0.0
786,2020,503333,Santa Clara County,San Jose,1.0,0,0,0,0,0,0,0,0,0,0,0.0,0.0,0.0,0.0
787,2021,503333,Santa Clara County,San Jose,1.0,0,0,0,0,0,0,0,0,0,0,0.0,0.0,0.0,0.0
788,2022,503333,Santa Clara County,San Jose,1.0,5,0,5,5,0,5,0,0,0,5,0.0,1.0,0.0,0.0
789,2023,503333,Santa Clara County,San Jose,1.0,4,0,4,4,0,4,0,0,0,4,0.0,1.0,0.0,0.0
790,2024,503333,Santa Clara County,San Jose,1.0,7,0,7,15,4,19,0,4,0,15,0.0,0.13333333333333333,0.0,1.0
791,All,503333,Santa Clara County,San Jose,1.0,16,0,16,24,4,28,0,4,0,24,0.0,0.4583333333333333,0.0,1.0
792,2018,503336,Santa Clara County,San Jose,1.0,0,0,0,0,0,0,0,0,0,0,0.0,0.0,0.0,0.0
793,2019,503336,Santa Clara County,San Jose,1.0,0,0,0,0,0,0,0,0,0,0,0.0,0.0,0.0,0.0
794,2020,503336,Santa Clara County,San Jose,1.0,0,0,0,0,0,0,0,0,0,0,0.0,0.0,0.0,0.0
795,2021,503336,Santa Clara County,San Jose,1.0,0,0,0,0,0,0,0,0,0,0,0.0,0.0,0.0,0.0
796,2022,503336,Santa Clara County,San Jose,1.0,5,0,5,5,0,5,0,0,0,5,0.0,1.0,0.0,0.0
797,2023,503336,Santa Clara County,San Jose,1.0,4,0,4,4,0,4,0,0,0,4,0.0,1.0,0.0,0.0
798,2024,503336,Santa Clara County,San Jose,1.0,2,0,2,0,2,2,0,2,0,0,0.0,0.0,0.0,1.0
799,All,503336,Santa Clara County,San Jose,1.0,11,0,11,9,2,11,0,2,0,9,0.0,1.0,0.0,1.0
800,2018,503337,Santa Clara County,San Jose,1.0,0,0,0,0,0,0,0,0,0,0,0.0,0.0,0.0,0.0
801,2019,503337,Santa Clara County,San Jose,1.0,0,0,0,0,0,0,0,0,0,0,0.0,0.0,0.0,0.0
802,2020,503337,Santa Clara County,San Jose,1.0,0,0,0,0,0,0,0,0,0,0,0.0,0.0,0.0,0.0
803,2021,503337,Santa Clara County,San Jose,1.0,0,0,0,0,0,0,0,0,0,0,0.0,0.0,0.0,0.0
804,2022,503337,Santa Clara County,San Jose,1.0,0,0,0,0,0,0,0,0,0,0,0.0,0.0,0.0,0.0
805,2023,503337,Santa Clara County,San Jose,1.0,0,0,0,0,0,0,0,0,0,0,0.0,0.0,0.0,0.0
806,2024,503337,Santa Clara County,San Jose,1.0,2,0,2,0,2,2,0,2,0,0,0.0,0.0,0.0,1.0
807,All,503337,Santa Clara County,San Jose,1.0,2,0,2,0,2,2,0,2,0,0,0.0,0.0,0.0,1.0
808,2018,503338,Santa Clara County,San Jose,0.664,0,0,0,0,0,0,0,0,0,0,0.0,0.0,0.0,0.0
809,2019,503338,Santa Clara County,San Jose,0.664,0,0,0,0,0,0,0,0,0,0,0.0,0.0,0.0,0.0
810,2020,503338,Santa Clara County,San Jose,0.664,0,0,0,0,0,0,0,0,0,0,0.0,0.0,0.0,0.0
811,2021,503338,Santa Clara County,San Jose,0.664,0,0,0,0,0,0,0,0,0,0,0.0,0.0,0.0,0.0
812,2022,503338,Santa Clara County,San Jose,0.664,2,0,2,2,0,2,0,0,0,2,0.0,1.0,0.0,0.0
813,2023,503338,Santa Clara County,San Jose,0.664,2,0,2,2,0,2,0,0,0,2,0.0,0.5,0.0,0.0
814,2024,503338,Santa Clara County,San Jose,0.664,0,0,0,0,0,0,0,0,0,0,0.0,0.0,0.0,0.0
815,All,503338,Santa Clara County,San Jose,0.664,4,0,4,4,0,4,0,0,0,4,0.0,0.75,0.0,0.0
816,2018,503339,Santa Clara County,San Jose,1.0,0,0,0,0,0,0,0,0,0,0,0.0,0.0,0.0,0.0
817,2019,503339,Santa Clara County,San Jose,1.0,0,0,0,0,0,0,0,0,0,0,0.0,0.0,0.0,0.0
818,2020,503339,Santa Clara County,San Jose,1.0,0,0,0,0,0,0,0,0,0,0,0.0,0.0,0.0,0.0
819,2021,503339,Santa Clara County,San Jose,1.0,0,0,0,0,0,0,0,0,0,0,0.0,0.0,0.0,0.0
820,2022,503339,Santa Clara County,San Jose,1.0,0,0,0,0,0,0,0,0,0,0,0.0,0.0,0.0,0.0
821,2023,503339,Santa Clara County,San Jose,1.0,4,0,4,4,0,4,0,0,0,4,0.0,0.75,0.0,0.0
822,2024,503339,Santa Clara County,San Jose,1.0,1,0,1,0,1,1,0,1,0,0,0.0,0.0,0.0,1.0
823,All,503339,Santa Clara County,San Jose,1.0,5,0,5,4,1,5,0,1,0,4,0.0,0.75,0.0,1.0
824,2018,503401,Santa Clara County,San Jose,1.0,0,0,0,0,0,0,0,0,0,0,0.0,0.0,0.0,0.0
825,2019,503401,Santa Clara County,San Jose,1.0,0,0,0,0,0,0,0,0,0,0,0.0,0.0,0.0,0.0
826,2020,503401,Santa Clara County,San Jose,1.0,0,0,0,0,0,0,0,0,0,0,0.0,0.0,0.0,0.0
827,2021,503401,Santa Clara County,San Jose,1.0,0,0,0,0,0,0,0,0,0,0,0.0,0.0,0.0,0.0
828,2022,503401,Santa Clara County,San Jose,1.0,5,0,5,5,0,5,0,0,0,5,0.0,1.0,0.0,0.0
829,2023,503401,Santa Clara County,San Jose,1.0,6,0,6,6,0,6,0,0,0,6,0.0,1.0,0.0,0.0
830,2024,503401,Santa Clara County,San Jose,1.0,6,0,6,1,5,6,0,5,0,1,0.0,1.0,0.0,1.0
831,All,503401,Santa Clara County,San Jose,1.0,17,0,17,12,5,17,0,5,0,12,0.0,1.0,0.0,1.0
832,2018,503402,Santa Clara County,San Jose,1.0,0,0,0,0,0,0,0,0,0,0,0.0,0.0,0.0,0.0
833,2019,503402,Santa Clara County,San Jose,1.0,0,0,0,0,0,0,0,0,0,0,0.0,0.0,0.0,0.0
834,2020,503402,Santa Clara County,San Jose,1.0,0,0,0,0,0,0,0,0,0,0,0.0,0.0,0.0,0.0
835,2021,503402,Santa Clara County,San Jose,1.0,0,0,0,0,0,0,0,0,0,0,0.0,0.0,0.0,0.0
836,2022,503402,Santa Clara County,San Jose,1.0,4,0,4,4,0,4,0,0,0,4,0.0,1.0,0.0,0.0
837,2023,503402,Santa Clara County,San Jose,1.0,2,0,2,2,0,2,0,0,0,2,0.0,1.0,0.0,0.0
838,2024,503402,Santa Clara County,San Jose,1.0,3,0,3,0,3,3,0,3,0,0,0.0,0.0,0.0,1.0
839,All,503402,Santa Clara County,San Jose,1.0,9,0,9,6,3,9,0,3,0,6,0.0,1.0,0.0,1.0
840,2018,503504,Santa Clara County,San Jose,1.0,0,0,0,0,0,0,0,0,0,0,0.0,0.0,0.0,0.0
841,2019,503504,Santa Clara County,San Jose,1.0,0,0,0,0,0,0,0,0,0,0,0.0,0.0,0.0,0.0
842,2020,503504,Santa Clara County,San Jose,1.0,0,0,0,0,0,0,0,0,0,0,0.0,0.0,0.0,0.0
843,2021,503504,Santa Clara County,San Jose,1.0,0,0,0,0,0,0,0,0,0,0,0.0,0.0,0.0,0.0
844,2022,503504,Santa Clara County,San Jose,1.0,3,0,3,3,0,3,0,0,0,3,0.0,1.0,0.0,0.0
845,2023,503504,Santa Clara County,San Jose,1.0,7,0,7,7,0,7,0,0,0,7,0.0,1.0,0.0,0.0
846,2024,503504,Santa Clara County,San Jose,1.0,4,0,4,0,4,4,0,4,0,0,0.0,0.0,0.0,1.0
847,All,503504,Santa Clara County,San Jose,1.0,14,0,14,10,4,14,0,4,0,10,0.0,1.0,0.0,1.0
848,2018,503506,Santa Clara County,San Jose,1.0,0,0,0,0,0,0,0,0,0,0,0.0,0.0,0.0,0.0
849,2019,503506,Santa Clara County,San Jose,1.0,0,0,0,0,0,0,0,0,0,0,0.0,0.0,0.0,0.0
850,2020,503506,Santa Clara County,San Jose,1.0,0,0,0,0,0,0,0,0,0,0,0.0,0.0,0.0,0.0
851,2021,503506,Santa Clara County,San Jose,1.0,0,0,0,0,0,0,0,0,0,0,0.0,0.0,0.0,0.0
852,2022,503506,Santa Clara County,San Jose,1.0,8,0,8,8,0,8,0,0,0,8,0.0,1.0,0.0,0.0
853,2023,503506,Santa Clara County,San Jose,1.0,4,0,4,4,0,4,0,0,0,4,0.0,1.0,0.0,0.0
854,2024,503506,Santa Clara County,San Jose,1.0,5,0,5,0,5,5,0,5,0,0,0.0,0.0,0.0,1.0
855,All,503506,Santa Clara County,San Jose,1.0,17,0,17,12,5,17,0,5,0,12,0.0,1.0,0.0,1.0
856,2018,503507,Santa Clara County,San Jose,1.0,0,0,0,0,0,0,0,0,0,0,0.0,0.0,0.0,0.0
857,2019,503507,Santa Clara County,San Jose,1.0,0,0,0,0,0,0,0,0,0,0,0.0,0.0,0.0,0.0
858,2020,503507,Santa Clara County,San Jose,1.0,0,0,0,0,0,0,0,0,0,0,0.0,0.0,0.0,0.0
859,2021,503507,Santa Clara County,San Jose,1.0,0,0,0,0,0,0,0,0,0,0,0.0,0.0,0.0,0.0
860,2022,503507,Santa Clara County,San Jose,1.0,2,0,2,2,0,2,0,0,0,2,0.0,1.0,0.0,0.0
861,2023,503507,Santa Clara County,San Jose,1.0,2,0,2,2,0,2,0,0,0,2,0.0,1.0,0.0,0.0
862,2024,503507,Santa Clara County,San Jose,1.0,2,0,2,0,2,2,0,2,0,0,0.0,0.0,0.0,1.0
863,All,503507,Santa Clara County,San Jose,1.0,6,0,6,4,2,6,0,2,0,4,0.0,1.0,0.0,1.0
864,2018,503508,Santa Clara County,San Jose,1.0,0,0,0,0,0,0,0,0,0,0,0.0,0.0,0.0,0.0
865,2019,503508,Santa Clara County,San Jose,1.0,0,0,0,0,0,0,0,0,0,0,0.0,0.0,0.0,0.0
866,2020,503508,Santa Clara County,San Jose,1.0,0,0,0,0,0,0,0,0,0,0,0.0,0.0,0.0,0.0
867,2021,503508,Santa Clara County,San Jose,1.0,0,0,0,0,0,0,0,0,0,0,0.0,0.0,0.0,0.0
868,2022,503508,Santa Clara County,San Jose,1.0,6,0,6,6,0,6,0,0,0,6,0.0,1.0,0.0,0.0
869,2023,503508,Santa Clara County,San Jose,1.0,4,0,4,4,0,4,0,0,0,4,0.0,1.0,0.0,0.0
870,2024,503508,Santa Clara County,San Jose,1.0,2,0,2,0,2,2,0,2,0,0,0.0,0.0,0.0,1.0
871,All,503508,Santa Clara County,San Jose,1.0,12,0,12,10,2,12,0,2,0,10,0.0,1.0,0.0,1.0
872,2018,503509,Santa Clara County,San Jose,1.0,0,0,0,0,0,0,0,0,0,0,0.0,0.0,0.0,0.0
873,2019,503509,Santa Clara County,San Jose,1.0,0,0,0,0,0,0,0,0,0,0,0.0,0.0,0.0,0.0
874,2020,503509,Santa Clara County,San Jose,1.0,0,0,0,0,0,0,0,0,0,0,0.0,0.0,0.0,0.0
875,2021,503509,Santa Clara County,San Jose,1.0,0,0,0,0,0,0,0,0,0,0,0.0,0.0,0.0,0.0
876,2022,503509,Santa Clara County,San Jose,1.0,0,0,0,0,0,0,0,0,0,0,0.0,0.0,0.0,0.0
877,2023,503509,Santa Clara County,San Jose,1.0,1,0,1,1,0,1,0,0,0,1,0.0,1.0,0.0,0.0
878,2024,503509,Santa Clara County,San Jose,1.0,5,0,5,2,3,5,0,3,0,2,0.0,1.0,0.0,1.0
879,All,503509,Santa Clara County,San Jose,1.0,6,0,6,3,3,6,0,3,0,3,0.0,1.0,0.0,1.0
880,2018,503510,Santa Clara County,San Jose,1.0,0,0,0,0,0,0,0,0,0,0,0.0,0.0,0.0,0.0
881,2019,503510,Santa Clara County,San Jose,1.0,0,0,0,0,0,0,0,0,0,0,0.0,0.0,0.0,0.0
882,2020,503510,Santa Clara County,San Jose,1.0,0,0,0,0,0,0,0,0,0,0,0.0,0.0,0.0,0.0
883,2021,503510,Santa Clara County,San Jose,1.0,0,0,0,0,0,0,0,0,0,0,0.0,0.0,0.0,0.0
884,2022,503510,Santa Clara County,San Jose,1.0,8,0,8,8,0,8,0,0,0,8,0.0,1.0,0.0,0.0
885,2023,503510,Santa Clara County,San Jose,1.0,3,0,3,3,0,3,0,0,0,3,0.0,1.0,0.0,0.0
886,2024,503510,Santa Clara County,San Jose,1.0,5,0,5,0,5,5,0,5,0,0,0.0,0.0,0.0,1.0
887,All,503510,Santa Clara County,San Jose,1.0,16,0,16,11,5,16,0,5,0,11,0.0,1.0,0.0,1.0
888,2018,503511,Santa Clara County,San Jose,1.0,0,0,0,0,0,0,0,0,0,0,0.0,0.0,0.0,0.0
889,2019,503511,Santa Clara County,San Jose,1.0,0,0,0,0,0,0,0,0,0,0,0.0,0.0,0.0,0.0
890,2020,503511,Santa Clara County,San Jose,1.0,0,0,0,0,0,0,0,0,0,0,0.0,0.0,0.0,0.0
891,2021,503511,Santa Clara County,San Jose,1.0,0,0,0,0,0,0,0,0,0,0,0.0,0.0,0.0,0.0
892,2022,503511,Santa Clara County,San Jose,1.0,4,0,4,4,0,4,0,0,0,4,0.0,1.0,0.0,0.0
893,2023,503511,Santa Clara County,San Jose,1.0,6,0,6,6,0,6,0,0,0,6,0.0,1.0,0.0,0.0
894,2024,503511,Santa Clara County,San Jose,1.0,4,0,4,2,2,4,0,2,0,2,0.0,1.0,0.0,1.0
895,All,503511,Santa Clara County,San Jose,1.0,14,0,14,12,2,14,0,2,0,12,0.0,1.0,0.0,1.0
896,2018,503601,Santa Clara County,San Jose,1.0,1,1,0,121,0,121,0,0,121,0,1.0,0.0,0.0,0.0
897,2019,503601,Santa Clara County,San Jose,1.0,0,0,0,0,0,0,0,0,0,0,0.0,0.0,0.0,0.0
898,2020,503601,Santa Clara County,San Jose,1.0,0,0,0,0,0,0,0,0,0,0,0.0,0.0,0.0,0.0
899,2021,503601,Santa Clara County,San Jose,1.0,0,0,0,0,0,0,0,0,0,0,0.0,0.0,0.0,0.0
900,2022,503601,Santa Clara County,San Jose,1.0,3,0,3,3,0,3,0,0,0,3,0.0,1.0,0.0,0.0
901,2023,503601,Santa Clara County,San Jose,1.0,3,1,2,5,0,5,0,0,2,3,0.0,1.0,0.0,0.0
902,2024,503601,Santa Clara County,San Jose,1.0,6,1,5,56,15,71,10,5,56,0,1.0,0.0,1.0,1.0
903,All,503601,Santa Clara County,San Jose,1.0,13,3,10,185,15,200,10,5,179,6,0.9888268156424581,1.0,1.0,1.0
904,2018,503602,Santa Clara County,San Jose,1.0,0,0,0,0,0,0,0,0,0,0,0.0,0.0,0.0,0.0
905,2019,503602,Santa Clara County,San Jose,1.0,0,0,0,0,0,0,0,0,0,0,0.0,0.0,0.0,0.0
906,2020,503602,Santa Clara County,San Jose,1.0,0,0,0,0,0,0,0,0,0,0,0.0,0.0,0.0,0.0
907,2021,503602,Santa Clara County,San Jose,1.0,0,0,0,0,0,0,0,0,0,0,0.0,0.0,0.0,0.0
908,2022,503602,Santa Clara County,San Jose,1.0,2,0,2,2,0,2,0,0,0,2,0.0,1.0,0.0,0.0
909,2023,503602,Santa Clara County,San Jose,1.0,2,0,2,2,0,2,0,0,0,2,0.0,1.0,0.0,0.0
910,2024,503602,Santa Clara County,San Jose,1.0,2,0,2,0,2,2,0,2,0,0,0.0,0.0,0.0,1.0
911,All,503602,Santa Clara County,San Jose,1.0,6,0,6,4,2,6,0,2,0,4,0.0,1.0,0.0,1.0
912,2018,503703,Santa Clara County,San Jose,1.0,0,0,0,0,0,0,0,0,0,0,0.0,0.0,0.0,0.0
913,2019,503703,Santa Clara County,San Jose,1.0,0,0,0,0,0,0,0,0,0,0,0.0,0.0,0.0,0.0
914,2020,503703,Santa Clara County,San Jose,1.0,0,0,0,0,0,0,0,0,0,0,0.0,0.0,0.0,0.0
915,2021,503703,Santa Clara County,San Jose,1.0,0,0,0,0,0,0,0,0,0,0,0.0,0.0,0.0,0.0
916,2022,503703,Santa Clara County,San Jose,1.0,2,0,2,2,0,2,0,0,0,2,0.0,1.0,0.0,0.0
917,2023,503703,Santa Clara County,San Jose,1.0,2,0,2,2,0,2,0,0,0,2,0.0,1.0,0.0,0.0
918,2024,503703,Santa Clara County,San Jose,1.0,2,0,2,1,1,2,0,1,0,1,0.0,1.0,0.0,1.0
919,All,503703,Santa Clara County,San Jose,1.0,6,0,6,5,1,6,0,1,0,5,0.0,1.0,0.0,1.0
920,2018,503707,Santa Clara County,San Jose,1.0,1,1,0,738,0,738,0,0,738,0,1.0,0.0,0.0,0.0
921,2019,503707,Santa Clara County,San Jose,1.0,0,0,0,0,0,0,0,0,0,0,0.0,0.0,0.0,0.0
922,2020,503707,Santa Clara County,San Jose,1.0,1,1,0,796,0,796,0,0,796,0,1.0,0.0,0.0,0.0
923,2021,503707,Santa Clara County,San Jose,1.0,0,0,0,0,0,0,0,0,0,0,0.0,0.0,0.0,0.0
924,2022,503707,Santa Clara County,San Jose,1.0,1,0,1,1,0,1,0,0,0,1,0.0,1.0,0.0,0.0
925,2023,503707,Santa Clara County,San Jose,1.0,2,0,2,2,0,2,0,0,0,2,0.0,1.0,0.0,0.0
926,2024,503707,Santa Clara County,San Jose,1.0,2,0,2,0,2,2,0,2,0,0,0.0,0.0,0.0,1.0
927,All,503707,Santa Clara County,San Jose,1.0,7,2,5,1537,2,1539,0,2,1534,3,1.0,1.0,0.0,1.0
928,2018,503708,Santa Clara County,San Jose,1.0,0,0,0,0,0,0,0,0,0,0,0.0,0.0,0.0,0.0
929,2019,503708,Santa Clara County,San Jose,1.0,0,0,0,0,0,0,0,0,0,0,0.0,0.0,0.0,0.0
930,2020,503708,Santa Clara County,San Jose,1.0,0,0,0,0,0,0,0,0,0,0,0.0,0.0,0.0,0.0
931,2021,503708,Santa Clara County,San Jose,1.0,0,0,0,0,0,0,0,0,0,0,0.0,0.0,0.0,0.0
932,2022,503708,Santa Clara County,San Jose,1.0,1,0,1,1,0,1,0,0,0,1,0.0,1.0,0.0,0.0
933,2023,503708,Santa Clara County,San Jose,1.0,4,0,4,4,0,4,0,0,0,4,0.0,1.0,0.0,0.0
934,2024,503708,Santa Clara County,San Jose,1.0,3,0,3,1,2,3,0,2,0,1,0.0,1.0,0.0,1.0
935,All,503708,Santa Clara County,San Jose,1.0,8,0,8,6,2,8,0,2,0,6,0.0,1.0,0.0,1.0
936,2018,503709,Santa Clara County,San Jose,1.0,0,0,0,0,0,0,0,0,0,0,0.0,0.0,0.0,0.0
937,2019,503709,Santa Clara County,San Jose,1.0,0,0,0,0,0,0,0,0,0,0,0.0,0.0,0.0,0.0
938,2020,503709,Santa Clara County,San Jose,1.0,0,0,0,0,0,0,0,0,0,0,0.0,0.0,0.0,0.0
939,2021,503709,Santa Clara County,San Jose,1.0,0,0,0,0,0,0,0,0,0,0,0.0,0.0,0.0,0.0
940,2022,503709,Santa Clara County,San Jose,1.0,2,0,2,2,0,2,0,0,0,2,0.0,1.0,0.0,0.0
941,2023,503709,Santa Clara County,San Jose,1.0,4,0,4,4,0,4,0,0,0,4,0.0,1.0,0.0,0.0
942,2024,503709,Santa Clara County,San Jose,1.0,3,0,3,1,2,3,0,2,0,1,0.0,1.0,0.0,1.0
943,All,503709,Santa Clara County,San Jose,1.0,9,0,9,7,2,9,0,2,0,7,0.0,1.0,0.0,1.0
944,2018,503710,Santa Clara County,San Jose,1.0,1,1,0,0,87,87,87,0,0,0,0.0,0.0,1.0,0.0
945,2019,503710,Santa Clara County,San Jose,1.0,1,1,0,14,0,14,0,0,14,0,1.0,0.0,0.0,0.0
946,2020,503710,Santa Clara County,San Jose,1.0,2,2,0,194,65,259,65,0,194,0,1.0,0.0,1.0,0.0
947,2021,503710,Santa Clara County,San Jose,1.0,1,0,1,1,0,1,0,0,0,1,0.0,0.0,0.0,0.0
948,2022,503710,Santa Clara County,San Jose,1.0,1,1,0,0,55,55,55,0,0,0,0.0,0.0,1.0,0.0
949,2023,503710,Santa Clara County,San Jose,1.0,3,0,3,3,0,3,0,0,0,3,0.0,1.0,0.0,0.0
950,2024,503710,Santa Clara County,San Jose,1.0,1,0,1,0,1,1,0,1,0,0,0.0,0.0,0.0,1.0
951,All,503710,Santa Clara County,San Jose,1.0,10,5,5,212,208,420,207,1,208,4,1.0,0.75,1.0,1.0
952,2018,503711,Santa Clara County,San Jose,1.0,0,0,0,0,0,0,0,0,0,0,0.0,0.0,0.0,0.0
953,2019,503711,Santa Clara County,San Jose,1.0,0,0,0,0,0,0,0,0,0,0,0.0,0.0,0.0,0.0
954,2020,503711,Santa Clara County,San Jose,1.0,0,0,0,0,0,0,0,0,0,0,0.0,0.0,0.0,0.0
955,2021,503711,Santa Clara County,San Jose,1.0,0,0,0,0,0,0,0,0,0,0,0.0,0.0,0.0,0.0
956,2022,503711,Santa Clara County,San Jose,1.0,1,0,1,1,0,1,0,0,0,1,0.0,1.0,0.0,0.0
957,2023,503711,Santa Clara County,San Jose,1.0,2,0,2,2,0,2,0,0,0,2,0.0,1.0,0.0,0.0
958,2024,503711,Santa Clara County,San Jose,1.0,5,0,5,0,5,5,0,5,0,0,0.0,0.0,0.0,1.0
959,All,503711,Santa Clara County,San Jose,1.0,8,0,8,3,5,8,0,5,0,3,0.0,1.0,0.0,1.0
960,2018,503712,Santa Clara County,San Jose,1.0,0,0,0,0,0,0,0,0,0,0,0.0,0.0,0.0,0.0
961,2019,503712,Santa Clara County,San Jose,1.0,0,0,0,0,0,0,0,0,0,0,0.0,0.0,0.0,0.0
962,2020,503712,Santa Clara County,San Jose,1.0,0,0,0,0,0,0,0,0,0,0,0.0,0.0,0.0,0.0
963,2021,503712,Santa Clara County,San Jose,1.0,0,0,0,0,0,0,0,0,0,0,0.0,0.0,0.0,0.0
964,2022,503712,Santa Clara County,San Jose,1.0,0,0,0,0,0,0,0,0,0,0,0.0,0.0,0.0,0.0
965,2023,503712,Santa Clara County,San Jose,1.0,0,0,0,0,0,0,0,0,0,0,0.0,0.0,0.0,0.0
966,2024,503712,Santa Clara County,San Jose,1.0,0,0,0,0,0,0,0,0,0,0,0.0,0.0,0.0,0.0
967,All,503712,Santa Clara County,San Jose,1.0,0,0,0,0,0,0,0,0,0,0,0.0,0.0,0.0,0.0
968,2018,503713,Santa Clara County,San Jose,1.0,0,0,0,0,0,0,0,0,0,0,0.0,0.0,0.0,0.0
969,2019,503713,Santa Clara County,San Jose,1.0,0,0,0,0,0,0,0,0,0,0,0.0,0.0,0.0,0.0
970,2020,503713,Santa Clara County,San Jose,1.0,0,0,0,0,0,0,0,0,0,0,0.0,0.0,0.0,0.0
971,2021,503713,Santa Clara County,San Jose,1.0,0,0,0,0,0,0,0,0,0,0,0.0,0.0,0.0,0.0
972,2022,503713,Santa Clara County,San Jose,1.0,0,0,0,0,0,0,0,0,0,0,0.0,0.0,0.0,0.0
973,2023,503713,Santa Clara County,San Jose,1.0,1,0,1,1,0,1,0,0,0,1,0.0,1.0,0.0,0.0
974,2024,503713,Santa Clara County,San Jose,1.0,0,0,0,0,0,0,0,0,0,0,0.0,0.0,0.0,0.0
975,All,503713,Santa Clara County,San Jose,1.0,1,0,1,1,0,1,0,0,0,1,0.0,1.0,0.0,0.0
976,2018,503802,Santa Clara County,San Jose,0.891,0,0,0,0,0,0,0,0,0,0,0.0,0.0,0.0,0.0
977,2019,503802,Santa Clara County,San Jose,0.891,0,0,0,0,0,0,0,0,0,0,0.0,0.0,0.0,0.0
978,2020,503802,Santa Clara County,San Jose,0.891,0,0,0,0,0,0,0,0,0,0,0.0,0.0,0.0,0.0
979,2021,503802,Santa Clara County,San Jose,0.891,0,0,0,0,0,0,0,0,0,0,0.0,0.0,0.0,0.0
980,2022,503802,Santa Clara County,San Jose,0.891,7,0,7,7,0,7,0,0,0,7,0.0,1.0,0.0,0.0
981,2023,503802,Santa Clara County,San Jose,0.891,6,0,6,6,0,6,0,0,0,6,0.0,1.0,0.0,0.0
982,2024,503802,Santa Clara County,San Jose,0.891,2,0,2,0,2,2,0,2,0,0,0.0,0.0,0.0,1.0
983,All,503802,Santa Clara County,San Jose,0.891,15,0,15,13,2,15,0,2,0,13,0.0,1.0,0.0,1.0
984,2018,503803,Santa Clara County,San Jose,1.0,0,0,0,0,0,0,0,0,0,0,0.0,0.0,0.0,0.0
985,2019,503803,Santa Clara County,San Jose,1.0,0,0,0,0,0,0,0,0,0,0,0.0,0.0,0.0,0.0
986,2020,503803,Santa Clara County,San Jose,1.0,0,0,0,0,0,0,0,0,0,0,0.0,0.0,0.0,0.0
987,2021,503803,Santa Clara County,San Jose,1.0,0,0,0,0,0,0,0,0,0,0,0.0,0.0,0.0,0.0
988,2022,503803,Santa Clara County,San Jose,1.0,1,0,1,1,0,1,0,0,0,1,0.0,1.0,0.0,0.0
989,2023,503803,Santa Clara County,San Jose,1.0,0,0,0,0,0,0,0,0,0,0,0.0,0.0,0.0,0.0
990,2024,503803,Santa Clara County,San Jose,1.0,1,0,1,0,1,1,0,1,0,0,0.0,0.0,0.0,1.0
991,All,503803,Santa Clara County,San Jose,1.0,2,0,2,1,1,2,0,1,0,1,0.0,1.0,0.0,1.0
992,2018,503804,Santa Clara County,San Jose,1.0,0,0,0,0,0,0,0,0,0,0,0.0,0.0,0.0,0.0
993,2019,503804,Santa Clara County,San Jose,1.0,1,1,0,188,0,188,0,0,188,0,1.0,0.0,0.0,0.0
994,2020,503804,Santa Clara County,San Jose,1.0,0,0,0,0,0,0,0,0,0,0,0.0,0.0,0.0,0.0
995,2021,503804,Santa Clara County,San Jose,1.0,0,0,0,0,0,0,0,0,0,0,0.0,0.0,0.0,0.0
996,2022,503804,Santa Clara County,San Jose,1.0,3,1,2,2,160,162,160,0,0,2,0.0,1.0,1.0,0.0
997,2023,503804,Santa Clara County,San Jose,1.0,4,0,4,4,0,4,0,0,0,4,0.0,1.0,0.0,0.0
998,2024,503804,Santa Clara County,San Jose,1.0,3,0,3,1,2,3,0,2,0,1,0.0,1.0,0.0,1.0
999,All,503804,Santa Clara County,San Jose,1.0,11,2,9,195,162,357,160,2,188,7,1.0,1.0,1.0,1.0
1000,2018,503902,Santa Clara County,San Jose,0.21,0,0,0,0,0,0,0,0,0,0,0.0,0.0,0.0,0.0
1001,2019,503902,Santa Clara County,San Jose,0.21,0,0,0,0,0,0,0,0,0,0,0.0,0.0,0.0,0.0
1002,2020,503902,Santa Clara County,San Jose,0.21,0,0,0,0,0,0,0,0,0,0,0.0,0.0,0.0,0.0
1003,2021,503902,Santa Clara County,San Jose,0.21,0,0,0,0,0,0,0,0,0,0,0.0,0.0,0.0,0.0
1004,2022,503902,Santa Clara County,San Jose,0.21,1,0,1,1,0,1,0,0,0,1,0.0,1.0,0.0,0.0
1005,2023,503902,Santa Clara County,San Jose,0.21,0,0,0,0,0,0,0,0,0,0,0.0,0.0,0.0,0.0
1006,2024,503902,Santa Clara County,San Jose,0.21,1,0,1,8,1,9,0,1,0,8,0.0,0.0,0.0,0.0
1007,All,503902,Santa Clara County,San Jose,0.21,2,0,2,9,1,10,0,1,0,9,0.0,0.1111111111111111,0.0,0.0
1008,2018,503903,Santa Clara County,San Jose,1.0,0,0,0,0,0,0,0,0,0,0,0.0,0.0,0.0,0.0
1009,2019,503903,Santa Clara County,San Jose,1.0,0,0,0,0,0,0,0,0,0,0,0.0,0.0,0.0,0.0
1010,2020,503903,Santa Clara County,San Jose,1.0,0,0,0,0,0,0,0,0,0,0,0.0,0.0,0.0,0.0
1011,2021,503903,Santa Clara County,San Jose,1.0,0,0,0,0,0,0,0,0,0,0,0.0,0.0,0.0,0.0
1012,2022,503903,Santa Clara County,San Jose,1.0,2,0,2,2,0,2,0,0,0,2,0.0,1.0,0.0,0.0
1013,2023,503903,Santa Clara County,San Jose,1.0,2,0,2,2,0,2,0,0,0,2,0.0,1.0,0.0,0.0
1014,2024,503903,Santa Clara County,San Jose,1.0,4,2,2,3,2,5,0,2,3,0,1.0,0.0,0.0,1.0
1015,All,503903,Santa Clara County,San Jose,1.0,8,2,6,7,2,9,0,2,3,4,1.0,1.0,0.0,1.0
1016,2018,504001,Santa Clara County,San Jose,1.0,0,0,0,0,0,0,0,0,0,0,0.0,0.0,0.0,0.0
1017,2019,504001,Santa Clara County,San Jose,1.0,0,0,0,0,0,0,0,0,0,0,0.0,0.0,0.0,0.0
1018,2020,504001,Santa Clara County,San Jose,1.0,1,1,0,0,166,166,166,0,0,0,0.0,0.0,1.0,0.0
1019,2021,504001,Santa Clara County,San Jose,1.0,0,0,0,0,0,0,0,0,0,0,0.0,0.0,0.0,0.0
1020,2022,504001,Santa Clara County,San Jose,1.0,8,1,7,7,63,70,63,0,0,7,0.0,1.0,1.0,0.0
1021,2023,504001,Santa Clara County,San Jose,1.0,3,0,3,3,0,3,0,0,0,3,0.0,1.0,0.0,0.0
1022,2024,504001,Santa Clara County,San Jose,1.0,5,2,3,31,308,339,305,3,31,0,0.0,0.0,0.9836065573770492,1.0
1023,All,504001,Santa Clara County,San Jose,1.0,17,4,13,41,537,578,534,3,31,10,0.0,1.0,0.9906367041198502,1.0
1024,2018,504002,Santa Clara County,San Jose,1.0,0,0,0,0,0,0,0,0,0,0,0.0,0.0,0.0,0.0
1025,2019,504002,Santa Clara County,San Jose,1.0,0,0,0,0,0,0,0,0,0,0,0.0,0.0,0.0,0.0
1026,2020,504002,Santa Clara County,San Jose,1.0,0,0,0,0,0,0,0,0,0,0,0.0,0.0,0.0,0.0
1027,2021,504002,Santa Clara County,San Jose,1.0,0,0,0,0,0,0,0,0,0,0,0.0,0.0,0.0,0.0
1028,2022,504002,Santa Clara County,San Jose,1.0,2,0,2,2,0,2,0,0,0,2,0.0,1.0,0.0,0.0
1029,2023,504002,Santa Clara County,San Jose,1.0,8,0,8,8,0,8,0,0,0,8,0.0,0.875,0.0,0.0
1030,2024,504002,Santa Clara County,San Jose,1.0,3,0,3,0,3,3,0,3,0,0,0.0,0.0,0.0,1.0
1031,All,504002,Santa Clara County,San Jose,1.0,13,0,13,10,3,13,0,3,0,10,0.0,0.9,0.0,1.0
1032,2018,504101,Santa Clara County,San Jose,0.242,0,0,0,0,0,0,0,0,0,0,0.0,0.0,0.0,0.0
1033,2019,504101,Santa Clara County,San Jose,0.242,0,0,0,0,0,0,0,0,0,0,0.0,0.0,0.0,0.0
1034,2020,504101,Santa Clara County,San Jose,0.242,0,0,0,0,0,0,0,0,0,0,0.0,0.0,0.0,0.0
1035,2021,504101,Santa Clara County,San Jose,0.242,0,0,0,0,0,0,0,0,0,0,0.0,0.0,0.0,0.0
1036,2022,504101,Santa Clara County,San Jose,0.242,0,0,0,0,0,0,0,0,0,0,0.0,0.0,0.0,0.0
1037,2023,504101,Santa Clara County,San Jose,0.242,0,0,0,0,0,0,0,0,0,0,0.0,0.0,0.0,0.0
1038,2024,504101,Santa Clara County,San Jose,0.242,1,0,1,0,1,1,0,1,0,0,0.0,0.0,0.0,1.0
1039,All,504101,Santa Clara County,San Jose,0.242,1,0,1,0,1,1,0,1,0,0,0.0,0.0,0.0,1.0
1040,2018,504102,Santa Clara County,San Jose,0.482,0,0,0,0,0,0,0,0,0,0,0.0,0.0,0.0,0.0
1041,2019,504102,Santa Clara County,San Jose,0.482,0,0,0,0,0,0,0,0,0,0,0.0,0.0,0.0,0.0
1042,2020,504102,Santa Clara County,San Jose,0.482,0,0,0,0,0,0,0,0,0,0,0.0,0.0,0.0,0.0
1043,2021,504102,Santa Clara County,San Jose,0.482,0,0,0,0,0,0,0,0,0,0,0.0,0.0,0.0,0.0
1044,2022,504102,Santa Clara County,San Jose,0.482,5,0,5,5,0,5,0,0,0,5,0.0,1.0,0.0,0.0
1045,2023,504102,Santa Clara County,San Jose,0.482,1,0,1,1,0,1,0,0,0,1,0.0,1.0,0.0,0.0
1046,2024,504102,Santa Clara County,San Jose,0.482,0,0,0,0,0,0,0,0,0,0,0.0,0.0,0.0,0.0
1047,All,504102,Santa Clara County,San Jose,0.482,6,0,6,6,0,6,0,0,0,6,0.0,1.0,0.0,0.0
1048,2018,504201,Santa Clara County,San Jose,0.16,0,0,0,0,0,0,0,0,0,0,0.0,0.0,0.0,0.0
1049,2019,504201,Santa Clara County,San Jose,0.16,0,0,0,0,0,0,0,0,0,0,0.0,0.0,0.0,0.0
1050,2020,504201,Santa Clara County,San Jose,0.16,0,0,0,0,0,0,0,0,0,0,0.0,0.0,0.0,0.0
1051,2021,504201,Santa Clara County,San Jose,0.16,0,0,0,0,0,0,0,0,0,0,0.0,0.0,0.0,0.0
1052,2022,504201,Santa Clara County,San Jose,0.16,0,0,0,0,0,0,0,0,0,0,0.0,0.0,0.0,0.0
1053,2023,504201,Santa Clara County,San Jose,0.16,0,0,0,0,0,0,0,0,0,0,0.0,0.0,0.0,0.0
1054,2024,504201,Santa Clara County,San Jose,0.16,1,0,1,0,1,1,0,1,0,0,0.0,0.0,0.0,1.0
1055,All,504201,Santa Clara County,San Jose,0.16,1,0,1,0,1,1,0,1,0,0,0.0,0.0,0.0,1.0
1056,2018,504202,Santa Clara County,San Jose,0.222,1,0,1,1,0,1,0,0,0,1,0.0,0.0,0.0,0.0
1057,2019,504202,Santa Clara County,San Jose,0.222,0,0,0,0,0,0,0,0,0,0,0.0,0.0,0.0,0.0
1058,2020,504202,Santa Clara County,San Jose,0.222,0,0,0,0,0,0,0,0,0,0,0.0,0.0,0.0,0.0
1059,2021,504202,Santa Clara County,San Jose,0.222,1,0,1,3,0,3,0,0,0,3,0.0,0.0,0.0,0.0
1060,2022,504202,Santa Clara County,San Jose,0.222,1,0,1,1,0,1,0,0,0,1,0.0,1.0,0.0,0.0
1061,2023,504202,Santa Clara County,San Jose,0.222,7,0,7,7,0,7,0,0,0,7,0.0,0.5714285714285714,0.0,0.0
1062,2024,504202,Santa Clara County,San Jose,0.222,4,0,4,2,2,4,0,2,0,2,0.0,0.5,0.0,1.0
1063,All,504202,Santa Clara County,San Jose,0.222,14,0,14,14,2,16,0,2,0,14,0.0,0.42857142857142855,0.0,1.0
1064,2018,504307,Santa Clara County,San Jose,1.0,1,1,0,6,0,6,0,0,6,0,0.0,0.0,0.0,0.0
1065,2019,504307,Santa Clara County,San Jose,1.0,1,0,1,6,0,6,0,0,0,6,0.0,0.0,0.0,0.0
1066,2020,504307,Santa Clara County,San Jose,1.0,0,0,0,0,0,0,0,0,0,0,0.0,0.0,0.0,0.0
1067,2021,504307,Santa Clara County,San Jose,1.0,1,1,0,382,0,382,0,0,382,0,1.0,0.0,0.0,0.0
1068,2022,504307,Santa Clara County,San Jose,1.0,2,0,2,2,0,2,0,0,0,2,0.0,1.0,0.0,0.0
1069,2023,504307,Santa Clara County,San Jose,1.0,2,0,2,4,0,4,0,0,0,4,0.0,0.25,0.0,0.0
1070,2024,504307,Santa Clara County,San Jose,1.0,0,0,0,0,0,0,0,0,0,0,0.0,0.0,0.0,0.0
1071,All,504307,Santa Clara County,San Jose,1.0,7,2,5,400,0,400,0,0,388,12,0.9845360824742269,0.25,0.0,0.0
1072,2018,504308,Santa Clara County,San Jose,0.475,0,0,0,0,0,0,0,0,0,0,0.0,0.0,0.0,0.0
1073,2019,504308,Santa Clara County,San Jose,0.475,0,0,0,0,0,0,0,0,0,0,0.0,0.0,0.0,0.0
1074,2020,504308,Santa Clara County,San Jose,0.475,0,0,0,0,0,0,0,0,0,0,0.0,0.0,0.0,0.0
1075,2021,504308,Santa Clara County,San Jose,0.475,0,0,0,0,0,0,0,0,0,0,0.0,0.0,0.0,0.0
1076,2022,504308,Santa Clara County,San Jose,0.475,2,0,2,2,0,2,0,0,0,2,0.0,1.0,0.0,0.0
1077,2023,504308,Santa Clara County,San Jose,0.475,6,0,6,6,0,6,0,0,0,6,0.0,0.8333333333333334,0.0,0.0
1078,2024,504308,Santa Clara County,San Jose,0.475,3,0,3,26,1,27,0,1,0,26,0.0,0.038461538461538464,0.0,1.0
1079,All,504308,Santa Clara County,San Jose,0.475,11,0,11,34,1,35,0,1,0,34,0.0,0.23529411764705882,0.0,1.0
1080,2018,504311,Santa Clara County,San Jose,1.0,0,0,0,0,0,0,0,0,0,0,0.0,0.0,0.0,0.0
1081,2019,504311,Santa Clara County,San Jose,1.0,0,0,0,0,0,0,0,0,0,0,0.0,0.0,0.0,0.0
1082,2020,504311,Santa Clara County,San Jose,1.0,0,0,0,0,0,0,0,0,0,0,0.0,0.0,0.0,0.0
1083,2021,504311,Santa Clara County,San Jose,1.0,0,0,0,0,0,0,0,0,0,0,0.0,0.0,0.0,0.0
1084,2022,504311,Santa Clara County,San Jose,1.0,0,0,0,0,0,0,0,0,0,0,0.0,0.0,0.0,0.0
1085,2023,504311,Santa Clara County,San Jose,1.0,1,0,1,1,0,1,0,0,0,1,0.0,1.0,0.0,0.0
1086,2024,504311,Santa Clara County,San Jose,1.0,1,1,0,53,13,66,13,0,53,0,0.0,0.0,0.0,0.0
1087,All,504311,Santa Clara County,San Jose,1.0,2,1,1,54,13,67,13,0,53,1,0.0,1.0,0.0,0.0
1088,2018,504314,Santa Clara County,San Jose,1.0,0,0,0,0,0,0,0,0,0,0,0.0,0.0,0.0,0.0
1089,2019,504314,Santa Clara County,San Jose,1.0,0,0,0,0,0,0,0,0,0,0,0.0,0.0,0.0,0.0
1090,2020,504314,Santa Clara County,San Jose,1.0,0,0,0,0,0,0,0,0,0,0,0.0,0.0,0.0,0.0
1091,2021,504314,Santa Clara County,San Jose,1.0,0,0,0,0,0,0,0,0,0,0,0.0,0.0,0.0,0.0
1092,2022,504314,Santa Clara County,San Jose,1.0,3,0,3,3,0,3,0,0,0,3,0.0,1.0,0.0,0.0
1093,2023,504314,Santa Clara County,San Jose,1.0,1,0,1,1,0,1,0,0,0,1,0.0,1.0,0.0,0.0
1094,2024,504314,Santa Clara County,San Jose,1.0,3,0,3,0,3,3,0,3,0,0,0.0,0.0,0.0,1.0
1095,All,504314,Santa Clara County,San Jose,1.0,7,0,7,4,3,7,0,3,0,4,0.0,1.0,0.0,1.0
1096,2018,504315,Santa Clara County,San Jose,1.0,0,0,0,0,0,0,0,0,0,0,0.0,0.0,0.0,0.0
1097,2019,504315,Santa Clara County,San Jose,1.0,0,0,0,0,0,0,0,0,0,0,0.0,0.0,0.0,0.0
1098,2020,504315,Santa Clara County,San Jose,1.0,0,0,0,0,0,0,0,0,0,0,0.0,0.0,0.0,0.0
1099,2021,504315,Santa Clara County,San Jose,1.0,0,0,0,0,0,0,0,0,0,0,0.0,0.0,0.0,0.0
1100,2022,504315,Santa Clara County,San Jose,1.0,3,0,3,3,0,3,0,0,0,3,0.0,1.0,0.0,0.0
1101,2023,504315,Santa Clara County,San Jose,1.0,2,0,2,2,0,2,0,0,0,2,0.0,1.0,0.0,0.0
1102,2024,504315,Santa Clara County,San Jose,1.0,4,0,4,0,4,4,0,4,0,0,0.0,0.0,0.0,1.0
1103,All,504315,Santa Clara County,San Jose,1.0,9,0,9,5,4,9,0,4,0,5,0.0,1.0,0.0,1.0
1104,2018,504316,Santa Clara County,San Jose,1.0,0,0,0,0,0,0,0,0,0,0,0.0,0.0,0.0,0.0
1105,2019,504316,Santa Clara County,San Jose,1.0,0,0,0,0,0,0,0,0,0,0,0.0,0.0,0.0,0.0
1106,2020,504316,Santa Clara County,San Jose,1.0,0,0,0,0,0,0,0,0,0,0,0.0,0.0,0.0,0.0
1107,2021,504316,Santa Clara County,San Jose,1.0,0,0,0,0,0,0,0,0,0,0,0.0,0.0,0.0,0.0
1108,2022,504316,Santa Clara County,San Jose,1.0,1,0,1,1,0,1,0,0,0,1,0.0,1.0,0.0,0.0
1109,2023,504316,Santa Clara County,San Jose,1.0,2,0,2,2,0,2,0,0,0,2,0.0,1.0,0.0,0.0
1110,2024,504316,Santa Clara County,San Jose,1.0,3,0,3,2,1,3,0,1,0,2,0.0,1.0,0.0,1.0
1111,All,504316,Santa Clara County,San Jose,1.0,6,0,6,5,1,6,0,1,0,5,0.0,1.0,0.0,1.0
1112,2018,504317,Santa Clara County,San Jose,1.0,0,0,0,0,0,0,0,0,0,0,0.0,0.0,0.0,0.0
1113,2019,504317,Santa Clara County,San Jose,1.0,0,0,0,0,0,0,0,0,0,0,0.0,0.0,0.0,0.0
1114,2020,504317,Santa Clara County,San Jose,1.0,0,0,0,0,0,0,0,0,0,0,0.0,0.0,0.0,0.0
1115,2021,504317,Santa Clara County,San Jose,1.0,0,0,0,0,0,0,0,0,0,0,0.0,0.0,0.0,0.0
1116,2022,504317,Santa Clara County,San Jose,1.0,2,0,2,2,0,2,0,0,0,2,0.0,1.0,0.0,0.0
1117,2023,504317,Santa Clara County,San Jose,1.0,2,0,2,2,0,2,0,0,0,2,0.0,1.0,0.0,0.0
1118,2024,504317,Santa Clara County,San Jose,1.0,7,0,7,0,7,7,0,7,0,0,0.0,0.0,0.0,1.0
1119,All,504317,Santa Clara County,San Jose,1.0,11,0,11,4,7,11,0,7,0,4,0.0,1.0,0.0,1.0
1120,2018,504318,Santa Clara County,San Jose,1.0,0,0,0,0,0,0,0,0,0,0,0.0,0.0,0.0,0.0
1121,2019,504318,Santa Clara County,San Jose,1.0,0,0,0,0,0,0,0,0,0,0,0.0,0.0,0.0,0.0
1122,2020,504318,Santa Clara County,San Jose,1.0,0,0,0,0,0,0,0,0,0,0,0.0,0.0,0.0,0.0
1123,2021,504318,Santa Clara County,San Jose,1.0,0,0,0,0,0,0,0,0,0,0,0.0,0.0,0.0,0.0
1124,2022,504318,Santa Clara County,San Jose,1.0,0,0,0,0,0,0,0,0,0,0,0.0,0.0,0.0,0.0
1125,2023,504318,Santa Clara County,San Jose,1.0,0,0,0,0,0,0,0,0,0,0,0.0,0.0,0.0,0.0
1126,2024,504318,Santa Clara County,San Jose,1.0,0,0,0,0,0,0,0,0,0,0,0.0,0.0,0.0,0.0
1127,All,504318,Santa Clara County,San Jose,1.0,0,0,0,0,0,0,0,0,0,0,0.0,0.0,0.0,0.0
1128,2018,504319,Santa Clara County,San Jose,1.0,0,0,0,0,0,0,0,0,0,0,0.0,0.0,0.0,0.0
1129,2019,504319,Santa Clara County,San Jose,1.0,0,0,0,0,0,0,0,0,0,0,0.0,0.0,0.0,0.0
1130,2020,504319,Santa Clara County,San Jose,1.0,0,0,0,0,0,0,0,0,0,0,0.0,0.0,0.0,0.0
1131,2021,504319,Santa Clara County,San Jose,1.0,0,0,0,0,0,0,0,0,0,0,0.0,0.0,0.0,0.0
1132,2022,504319,Santa Clara County,San Jose,1.0,0,0,0,0,0,0,0,0,0,0,0.0,0.0,0.0,0.0
1133,2023,504319,Santa Clara County,San Jose,1.0,2,1,1,1,195,196,195,0,0,1,0.0,1.0,1.0,0.0
1134,2024,504319,Santa Clara County,San Jose,1.0,0,0,0,0,0,0,0,0,0,0,0.0,0.0,0.0,0.0
1135,All,504319,Santa Clara County,San Jose,1.0,2,1,1,1,195,196,195,0,0,1,0.0,1.0,1.0,0.0
1136,2018,504320,Santa Clara County,San Jose,1.0,0,0,0,0,0,0,0,0,0,0,0.0,0.0,0.0,0.0
1137,2019,504320,Santa Clara County,San Jose,1.0,0,0,0,0,0,0,0,0,0,0,0.0,0.0,0.0,0.0
1138,2020,504320,Santa Clara County,San Jose,1.0,0,0,0,0,0,0,0,0,0,0,0.0,0.0,0.0,0.0
1139,2021,504320,Santa Clara County,San Jose,1.0,0,0,0,0,0,0,0,0,0,0,0.0,0.0,0.0,0.0
1140,2022,504320,Santa Clara County,San Jose,1.0,2,0,2,2,0,2,0,0,0,2,0.0,1.0,0.0,0.0
1141,2023,504320,Santa Clara County,San Jose,1.0,2,0,2,2,0,2,0,0,0,2,0.0,1.0,0.0,0.0
1142,2024,504320,Santa Clara County,San Jose,1.0,2,0,2,0,2,2,0,2,0,0,0.0,0.0,0.0,1.0
1143,All,504320,Santa Clara County,San Jose,1.0,6,0,6,4,2,6,0,2,0,4,0.0,1.0,0.0,1.0
1144,2018,504321,Santa Clara County,San Jose,0.957,0,0,0,0,0,0,0,0,0,0,0.0,0.0,0.0,0.0
1145,2019,504321,Santa Clara County,San Jose,0.957,0,0,0,0,0,0,0,0,0,0,0.0,0.0,0.0,0.0
1146,2020,504321,Santa Clara County,San Jose,0.957,0,0,0,0,0,0,0,0,0,0,0.0,0.0,0.0,0.0
1147,2021,504321,Santa Clara County,San Jose,0.957,0,0,0,0,0,0,0,0,0,0,0.0,0.0,0.0,0.0
1148,2022,504321,Santa Clara County,San Jose,0.957,2,0,2,2,0,2,0,0,0,2,0.0,1.0,0.0,0.0
1149,2023,504321,Santa Clara County,San Jose,0.957,3,0,3,3,0,3,0,0,0,3,0.0,1.0,0.0,0.0
1150,2024,504321,Santa Clara County,San Jose,0.957,5,1,4,1,131,132,127,4,1,0,1.0,0.0,1.0,1.0
1151,All,504321,Santa Clara County,San Jose,0.957,10,1,9,6,131,137,127,4,1,5,1.0,1.0,1.0,1.0
1152,2018,504322,Santa Clara County,San Jose,1.0,0,0,0,0,0,0,0,0,0,0,0.0,0.0,0.0,0.0
1153,2019,504322,Santa Clara County,San Jose,1.0,0,0,0,0,0,0,0,0,0,0,0.0,0.0,0.0,0.0
1154,2020,504322,Santa Clara County,San Jose,1.0,0,0,0,0,0,0,0,0,0,0,0.0,0.0,0.0,0.0
1155,2021,504322,Santa Clara County,San Jose,1.0,0,0,0,0,0,0,0,0,0,0,0.0,0.0,0.0,0.0
1156,2022,504322,Santa Clara County,San Jose,1.0,0,0,0,0,0,0,0,0,0,0,0.0,0.0,0.0,0.0
1157,2023,504322,Santa Clara County,San Jose,1.0,1,0,1,1,0,1,0,0,0,1,0.0,1.0,0.0,0.0
1158,2024,504322,Santa Clara County,San Jose,1.0,0,0,0,0,0,0,0,0,0,0,0.0,0.0,0.0,0.0
1159,All,504322,Santa Clara County,San Jose,1.0,1,0,1,1,0,1,0,0,0,1,0.0,1.0,0.0,0.0
1160,2018,504323,Santa Clara County,San Jose,1.0,0,0,0,0,0,0,0,0,0,0,0.0,0.0,0.0,0.0
1161,2019,504323,Santa Clara County,San Jose,1.0,0,0,0,0,0,0,0,0,0,0,0.0,0.0,0.0,0.0
1162,2020,504323,Santa Clara County,San Jose,1.0,0,0,0,0,0,0,0,0,0,0,0.0,0.0,0.0,0.0
1163,2021,504323,Santa Clara County,San Jose,1.0,0,0,0,0,0,0,0,0,0,0,0.0,0.0,0.0,0.0
1164,2022,504323,Santa Clara County,San Jose,1.0,3,0,3,3,0,3,0,0,0,3,0.0,1.0,0.0,0.0
1165,2023,504323,Santa Clara County,San Jose,1.0,0,0,0,0,0,0,0,0,0,0,0.0,0.0,0.0,0.0
1166,2024,504323,Santa Clara County,San Jose,1.0,4,0,4,0,4,4,0,4,0,0,0.0,0.0,0.0,1.0
1167,All,504323,Santa Clara County,San Jose,1.0,7,0,7,3,4,7,0,4,0,3,0.0,1.0,0.0,1.0
1168,2018,504410,Santa Clara County,San Jose,1.0,0,0,0,0,0,0,0,0,0,0,0.0,0.0,0.0,0.0
1169,2019,504410,Santa Clara County,San Jose,1.0,0,0,0,0,0,0,0,0,0,0,0.0,0.0,0.0,0.0
1170,2020,504410,Santa Clara County,San Jose,1.0,0,0,0,0,0,0,0,0,0,0,0.0,0.0,0.0,0.0
1171,2021,504410,Santa Clara County,San Jose,1.0,0,0,0,0,0,0,0,0,0,0,0.0,0.0,0.0,0.0
1172,2022,504410,Santa Clara County,San Jose,1.0,4,0,4,4,0,4,0,0,0,4,0.0,1.0,0.0,0.0
1173,2023,504410,Santa Clara County,San Jose,1.0,3,0,3,3,0,3,0,0,0,3,0.0,1.0,0.0,0.0
1174,2024,504410,Santa Clara County,San Jose,1.0,1,0,1,1,0,1,0,0,0,1,0.0,1.0,0.0,0.0
1175,All,504410,Santa Clara County,San Jose,1.0,8,0,8,8,0,8,0,0,0,8,0.0,1.0,0.0,0.0
1176,2018,504411,Santa Clara County,San Jose,1.0,0,0,0,0,0,0,0,0,0,0,0.0,0.0,0.0,0.0
1177,2019,504411,Santa Clara County,San Jose,1.0,0,0,0,0,0,0,0,0,0,0,0.0,0.0,0.0,0.0
1178,2020,504411,Santa Clara County,San Jose,1.0,0,0,0,0,0,0,0,0,0,0,0.0,0.0,0.0,0.0
1179,2021,504411,Santa Clara County,San Jose,1.0,0,0,0,0,0,0,0,0,0,0,0.0,0.0,0.0,0.0
1180,2022,504411,Santa Clara County,San Jose,1.0,0,0,0,0,0,0,0,0,0,0,0.0,0.0,0.0,0.0
1181,2023,504411,Santa Clara County,San Jose,1.0,2,0,2,2,0,2,0,0,0,2,0.0,1.0,0.0,0.0
1182,2024,504411,Santa Clara County,San Jose,1.0,3,0,3,0,3,3,0,3,0,0,0.0,0.0,0.0,1.0
1183,All,504411,Santa Clara County,San Jose,1.0,5,0,5,2,3,5,0,3,0,2,0.0,1.0,0.0,1.0
1184,2018,504424,Santa Clara County,San Jose,0.023,0,0,0,0,0,0,0,0,0,0,0.0,0.0,0.0,0.0
1185,2019,504424,Santa Clara County,San Jose,0.023,0,0,0,0,0,0,0,0,0,0,0.0,0.0,0.0,0.0
1186,2020,504424,Santa Clara County,San Jose,0.023,0,0,0,0,0,0,0,0,0,0,0.0,0.0,0.0,0.0
1187,2021,504424,Santa Clara County,San Jose,0.023,0,0,0,0,0,0,0,0,0,0,0.0,0.0,0.0,0.0
1188,2022,504424,Santa Clara County,San Jose,0.023,0,0,0,0,0,0,0,0,0,0,0.0,0.0,0.0,0.0
1189,2023,504424,Santa Clara County,San Jose,0.023,0,0,0,0,0,0,0,0,0,0,0.0,0.0,0.0,0.0
1190,2024,504424,Santa Clara County,San Jose,0.023,1,1,0,1,0,1,0,0,1,0,1.0,0.0,0.0,0.0
1191,All,504424,Santa Clara County,San Jose,0.023,1,1,0,1,0,1,0,0,1,0,1.0,0.0,0.0,0.0
1192,2018,504602,Santa Clara County,San Jose,0.755,0,0,0,0,0,0,0,0,0,0,0.0,0.0,0.0,0.0
1193,2019,504602,Santa Clara County,San Jose,0.755,0,0,0,0,0,0,0,0,0,0,0.0,0.0,0.0,0.0
1194,2020,504602,Santa Clara County,San Jose,0.755,0,0,0,0,0,0,0,0,0,0,0.0,0.0,0.0,0.0
1195,2021,504602,Santa Clara County,San Jose,0.755,0,0,0,0,0,0,0,0,0,0,0.0,0.0,0.0,0.0
1196,2022,504602,Santa Clara County,San Jose,0.755,0,0,0,0,0,0,0,0,0,0,0.0,0.0,0.0,0.0
1197,2023,504602,Santa Clara County,San Jose,0.755,2,0,2,2,0,2,0,0,0,2,0.0,0.5,0.0,0.0
1198,2024,504602,Santa Clara County,San Jose,0.755,1,0,1,0,1,1,0,1,0,0,0.0,0.0,0.0,1.0
1199,All,504602,Santa Clara County,San Jose,0.755,3,0,3,2,1,3,0,1,0,2,0.0,0.5,0.0,1.0
1200,2018,505006,Santa Clara County,San Jose,0.785,0,0,0,0,0,0,0,0,0,0,0.0,0.0,0.0,0.0
1201,2019,505006,Santa Clara County,San Jose,0.785,0,0,0,0,0,0,0,0,0,0,0.0,0.0,0.0,0.0
1202,2020,505006,Santa Clara County,San Jose,0.785,0,0,0,0,0,0,0,0,0,0,0.0,0.0,0.0,0.0
1203,2021,505006,Santa Clara County,San Jose,0.785,0,0,0,0,0,0,0,0,0,0,0.0,0.0,0.0,0.0
1204,2022,505006,Santa Clara County,San Jose,0.785,0,0,0,0,0,0,0,0,0,0,0.0,0.0,0.0,0.0
1205,2023,505006,Santa Clara County,San Jose,0.785,0,0,0,0,0,0,0,0,0,0,0.0,0.0,0.0,0.0
1206,2024,505006,Santa Clara County,San Jose,0.785,2,2,0,460,145,605,145,0,460,0,0.7869565217391304,0.0,0.8275862068965517,0.0
1207,All,505006,Santa Clara County,San Jose,0.785,2,2,0,460,145,605,145,0,460,0,0.7869565217391304,0.0,0.8275862068965517,0.0
1208,2018,505012,Santa Clara County,San Jose,1.0,0,0,0,0,0,0,0,0,0,0,0.0,0.0,0.0,0.0
1209,2019,505012,Santa Clara County,San Jose,1.0,0,0,0,0,0,0,0,0,0,0,0.0,0.0,0.0,0.0
1210,2020,505012,Santa Clara County,San Jose,1.0,0,0,0,0,0,0,0,0,0,0,0.0,0.0,0.0,0.0
1211,2021,505012,Santa Clara County,San Jose,1.0,0,0,0,0,0,0,0,0,0,0,0.0,0.0,0.0,0.0
1212,2022,505012,Santa Clara County,San Jose,1.0,0,0,0,0,0,0,0,0,0,0,0.0,0.0,0.0,0.0
1213,2023,505012,Santa Clara County,San Jose,1.0,0,0,0,0,0,0,0,0,0,0,0.0,0.0,0.0,0.0
1214,2024,505012,Santa Clara County,San Jose,1.0,6,0,6,0,6,6,0,6,0,0,0.0,0.0,0.0,1.0
1215,All,505012,Santa Clara County,San Jose,1.0,6,0,6,0,6,6,0,6,0,0,0.0,0.0,0.0,1.0
1216,2018,505013,Santa Clara County,San Jose,1.0,0,0,0,0,0,0,0,0,0,0,0.0,0.0,0.0,0.0
1217,2019,505013,Santa Clara County,San Jose,1.0,0,0,0,0,0,0,0,0,0,0,0.0,0.0,0.0,0.0
1218,2020,505013,Santa Clara County,San Jose,1.0,0,0,0,0,0,0,0,0,0,0,0.0,0.0,0.0,0.0
1219,2021,505013,Santa Clara County,San Jose,1.0,0,0,0,0,0,0,0,0,0,0,0.0,0.0,0.0,0.0
1220,2022,505013,Santa Clara County,San Jose,1.0,0,0,0,0,0,0,0,0,0,0,0.0,0.0,0.0,0.0
1221,2023,505013,Santa Clara County,San Jose,1.0,0,0,0,0,0,0,0,0,0,0,0.0,0.0,0.0,0.0
1222,2024,505013,Santa Clara County,San Jose,1.0,0,0,0,0,0,0,0,0,0,0,0.0,0.0,0.0,0.0
1223,All,505013,Santa Clara County,San Jose,1.0,0,0,0,0,0,0,0,0,0,0,0.0,0.0,0.0,0.0
1224,2018,505014,Santa Clara County,San Jose,1.0,0,0,0,0,0,0,0,0,0,0,0.0,0.0,0.0,0.0
1225,2019,505014,Santa Clara County,San Jose,1.0,0,0,0,0,0,0,0,0,0,0,0.0,0.0,0.0,0.0
1226,2020,505014,Santa Clara County,San Jose,1.0,0,0,0,0,0,0,0,0,0,0,0.0,0.0,0.0,0.0
1227,2021,505014,Santa Clara County,San Jose,1.0,0,0,0,0,0,0,0,0,0,0,0.0,0.0,0.0,0.0
1228,2022,505014,Santa Clara County,San Jose,1.0,0,0,0,0,0,0,0,0,0,0,0.0,0.0,0.0,0.0
1229,2023,505014,Santa Clara County,San Jose,1.0,1,1,0,2,444,446,444,0,2,0,1.0,0.0,1.0,0.0
1230,2024,505014,Santa Clara County,San Jose,1.0,0,0,0,0,0,0,0,0,0,0,0.0,0.0,0.0,0.0
1231,All,505014,Santa Clara County,San Jose,1.0,1,1,0,2,444,446,444,0,2,0,1.0,0.0,1.0,0.0
1232,2018,505015,Santa Clara County,San Jose,1.0,0,0,0,0,0,0,0,0,0,0,0.0,0.0,0.0,0.0
1233,2019,505015,Santa Clara County,San Jose,1.0,0,0,0,0,0,0,0,0,0,0,0.0,0.0,0.0,0.0
1234,2020,505015,Santa Clara County,San Jose,1.0,0,0,0,0,0,0,0,0,0,0,0.0,0.0,0.0,0.0
1235,2021,505015,Santa Clara County,San Jose,1.0,0,0,0,0,0,0,0,0,0,0,0.0,0.0,0.0,0.0
1236,2022,505015,Santa Clara County,San Jose,1.0,2,1,1,334,0,334,0,0,292,42,1.0,0.0,0.0,0.0
1237,2023,505015,Santa Clara County,San Jose,1.0,0,0,0,0,0,0,0,0,0,0,0.0,0.0,0.0,0.0
1238,2024,505015,Santa Clara County,San Jose,1.0,0,0,0,0,0,0,0,0,0,0,0.0,0.0,0.0,0.0
1239,All,505015,Santa Clara County,San Jose,1.0,2,1,1,334,0,334,0,0,292,42,1.0,0.0,0.0,0.0
1240,2018,505100,Santa Clara County,San Jose,0.961,0,0,0,0,0,0,0,0,0,0,0.0,0.0,0.0,0.0
1241,2019,505100,Santa Clara County,San Jose,0.961,0,0,0,0,0,0,0,0,0,0,0.0,0.0,0.0,0.0
1242,2020,505100,Santa Clara County,San Jose,0.961,0,0,0,0,0,0,0,0,0,0,0.0,0.0,0.0,0.0
1243,2021,505100,Santa Clara County,San Jose,0.961,0,0,0,0,0,0,0,0,0,0,0.0,0.0,0.0,0.0
1244,2022,505100,Santa Clara County,San Jose,0.961,2,1,1,1,43,44,43,0,0,1,0.0,1.0,1.0,0.0
1245,2023,505100,Santa Clara County,San Jose,0.961,4,0,4,4,0,4,0,0,0,4,0.0,1.0,0.0,0.0
1246,2024,505100,Santa Clara County,San Jose,0.961,1,0,1,1,0,1,0,0,0,1,0.0,1.0,0.0,0.0
1247,All,505100,Santa Clara County,San Jose,0.961,7,1,6,6,43,49,43,0,0,6,0.0,1.0,1.0,0.0
1248,2018,505203,Santa Clara County,San Jose,0.413,0,0,0,0,0,0,0,0,0,0,0.0,0.0,0.0,0.0
1249,2019,505203,Santa Clara County,San Jose,0.413,1,1,0,290,0,290,0,0,290,0,1.0,0.0,0.0,0.0
1250,2020,505203,Santa Clara County,San Jose,0.413,0,0,0,0,0,0,0,0,0,0,0.0,0.0,0.0,0.0
1251,2021,505203,Santa Clara County,San Jose,0.413,2,2,0,2,110,112,110,0,2,0,1.0,0.0,1.0,0.0
1252,2022,505203,Santa Clara County,San Jose,0.413,5,2,3,173,30,203,30,0,170,3,1.0,1.0,1.0,0.0
1253,2023,505203,Santa Clara County,San Jose,0.413,1,0,1,1,0,1,0,0,0,1,0.0,1.0,0.0,0.0
1254,2024,505203,Santa Clara County,San Jose,0.413,2,1,1,11,176,187,174,2,0,11,0.0,0.0,1.0,0.0
1255,All,505203,Santa Clara County,San Jose,0.413,11,6,5,477,316,793,314,2,462,15,1.0,0.26666666666666666,1.0,0.0
1256,2018,505800,Santa Clara County,San Jose,0.946,0,0,0,0,0,0,0,0,0,0,0.0,0.0,0.0,0.0
1257,2019,505800,Santa Clara County,San Jose,0.946,0,0,0,0,0,0,0,0,0,0,0.0,0.0,0.0,0.0
1258,2020,505800,Santa Clara County,San Jose,0.946,0,0,0,0,0,0,0,0,0,0,0.0,0.0,0.0,0.0
1259,2021,505800,Santa Clara County,San Jose,0.946,0,0,0,0,0,0,0,0,0,0,0.0,0.0,0.0,0.0
1260,2022,505800,Santa Clara County,San Jose,0.946,10,0,10,10,0,10,0,0,0,10,0.0,1.0,0.0,0.0
1261,2023,505800,Santa Clara County,San Jose,0.946,4,0,4,4,0,4,0,0,0,4,0.0,1.0,0.0,0.0
1262,2024,505800,Santa Clara County,San Jose,0.946,10,1,9,137,7,144,0,7,135,2,1.0,1.0,0.0,1.0
1263,All,505800,Santa Clara County,San Jose,0.946,24,1,23,151,7,158,0,7,135,16,1.0,1.0,0.0,1.0
1264,2018,505901,Santa Clara County,San Jose,0.056,0,0,0,0,0,0,0,0,0,0,0.0,0.0,0.0,0.0
1265,2019,505901,Santa Clara County,San Jose,0.056,0,0,0,0,0,0,0,0,0,0,0.0,0.0,0.0,0.0
1266,2020,505901,Santa Clara County,San Jose,0.056,0,0,0,0,0,0,0,0,0,0,0.0,0.0,0.0,0.0
1267,2021,505901,Santa Clara County,San Jose,0.056,0,0,0,0,0,0,0,0,0,0,0.0,0.0,0.0,0.0
1268,2022,505901,Santa Clara County,San Jose,0.056,0,0,0,0,0,0,0,0,0,0,0.0,0.0,0.0,0.0
1269,2023,505901,Santa Clara County,San Jose,0.056,0,0,0,0,0,0,0,0,0,0,0.0,0.0,0.0,0.0
1270,2024,505901,Santa Clara County,San Jose,0.056,0,0,0,0,0,0,0,0,0,0,0.0,0.0,0.0,0.0
1271,All,505901,Santa Clara County,San Jose,0.056,0,0,0,0,0,0,0,0,0,0,0.0,0.0,0.0,0.0
1272,2018,505902,Santa Clara County,San Jose,0.11,0,0,0,0,0,0,0,0,0,0,0.0,0.0,0.0,0.0
1273,2019,505902,Santa Clara County,San Jose,0.11,0,0,0,0,0,0,0,0,0,0,0.0,0.0,0.0,0.0
1274,2020,505902,Santa Clara County,San Jose,0.11,0,0,0,0,0,0,0,0,0,0,0.0,0.0,0.0,0.0
1275,2021,505902,Santa Clara County,San Jose,0.11,0,0,0,0,0,0,0,0,0,0,0.0,0.0,0.0,0.0
1276,2022,505902,Santa Clara County,San Jose,0.11,0,0,0,0,0,0,0,0,0,0,0.0,0.0,0.0,0.0
1277,2023,505902,Santa Clara County,San Jose,0.11,2,0,2,2,0,2,0,0,0,2,0.0,1.0,0.0,0.0
1278,2024,505902,Santa Clara County,San Jose,0.11,0,0,0,0,0,0,0,0,0,0,0.0,0.0,0.0,0.0
1279,All,505902,Santa Clara County,San Jose,0.11,2,0,2,2,0,2,0,0,0,2,0.0,1.0,0.0,0.0
1280,2018,506202,Santa Clara County,San Jose,1.0,0,0,0,0,0,0,0,0,0,0,0.0,0.0,0.0,0.0
1281,2019,506202,Santa Clara County,San Jose,1.0,0,0,0,0,0,0,0,0,0,0,0.0,0.0,0.0,0.0
1282,2020,506202,Santa Clara County,San Jose,1.0,0,0,0,0,0,0,0,0,0,0,0.0,0.0,0.0,0.0
1283,2021,506202,Santa Clara County,San Jose,1.0,0,0,0,0,0,0,0,0,0,0,0.0,0.0,0.0,0.0
1284,2022,506202,Santa Clara County,San Jose,1.0,5,0,5,5,0,5,0,0,0,5,0.0,1.0,0.0,0.0
1285,2023,506202,Santa Clara County,San Jose,1.0,1,0,1,1,0,1,0,0,0,1,0.0,1.0,0.0,0.0
1286,2024,506202,Santa Clara County,San Jose,1.0,6,0,6,2,4,6,0,4,0,2,0.0,1.0,0.0,1.0
1287,All,506202,Santa Clara County,San Jose,1.0,12,0,12,8,4,12,0,4,0,8,0.0,1.0,0.0,1.0
1288,2018,506203,Santa Clara County,San Jose,1.0,0,0,0,0,0,0,0,0,0,0,0.0,0.0,0.0,0.0
1289,2019,506203,Santa Clara County,San Jose,1.0,0,0,0,0,0,0,0,0,0,0,0.0,0.0,0.0,0.0
1290,2020,506203,Santa Clara County,San Jose,1.0,0,0,0,0,0,0,0,0,0,0,0.0,0.0,0.0,0.0
1291,2021,506203,Santa Clara County,San Jose,1.0,1,1,0,580,0,580,0,0,580,0,1.0,0.0,0.0,0.0
1292,2022,506203,Santa Clara County,San Jose,1.0,0,0,0,0,0,0,0,0,0,0,0.0,0.0,0.0,0.0
1293,2023,506203,Santa Clara County,San Jose,1.0,2,0,2,2,0,2,0,0,0,2,0.0,1.0,0.0,0.0
1294,2024,506203,Santa Clara County,San Jose,1.0,0,0,0,0,0,0,0,0,0,0,0.0,0.0,0.0,0.0
1295,All,506203,Santa Clara County,San Jose,1.0,3,1,2,582,0,582,0,0,580,2,1.0,1.0,0.0,0.0
1296,2018,506204,Santa Clara County,San Jose,1.0,0,0,0,0,0,0,0,0,0,0,0.0,0.0,0.0,0.0
1297,2019,506204,Santa Clara County,San Jose,1.0,0,0,0,0,0,0,0,0,0,0,0.0,0.0,0.0,0.0
1298,2020,506204,Santa Clara County,San Jose,1.0,0,0,0,0,0,0,0,0,0,0,0.0,0.0,0.0,0.0
1299,2021,506204,Santa Clara County,San Jose,1.0,0,0,0,0,0,0,0,0,0,0,0.0,0.0,0.0,0.0
1300,2022,506204,Santa Clara County,San Jose,1.0,2,0,2,2,0,2,0,0,0,2,0.0,1.0,0.0,0.0
1301,2023,506204,Santa Clara County,San Jose,1.0,4,0,4,5,0,5,0,0,0,5,0.0,1.0,0.0,0.0
1302,2024,506204,Santa Clara County,San Jose,1.0,3,0,3,0,3,3,0,3,0,0,0.0,0.0,0.0,1.0
1303,All,506204,Santa Clara County,San Jose,1.0,9,0,9,7,3,10,0,3,0,7,0.0,1.0,0.0,1.0
1304,2018,506301,Santa Clara County,San Jose,1.0,0,0,0,0,0,0,0,0,0,0,0.0,0.0,0.0,0.0
1305,2019,506301,Santa Clara County,San Jose,1.0,4,3,1,731,0,731,0,0,730,1,1.0,0.0,0.0,0.0
1306,2020,506301,Santa Clara County,San Jose,1.0,0,0,0,0,0,0,0,0,0,0,0.0,0.0,0.0,0.0
1307,2021,506301,Santa Clara County,San Jose,1.0,0,0,0,0,0,0,0,0,0,0,0.0,0.0,0.0,0.0
1308,2022,506301,Santa Clara County,San Jose,1.0,2,0,2,2,0,2,0,0,0,2,0.0,1.0,0.0,0.0
1309,2023,506301,Santa Clara County,San Jose,1.0,0,0,0,0,0,0,0,0,0,0,0.0,0.0,0.0,0.0
1310,2024,506301,Santa Clara County,San Jose,1.0,7,0,7,0,7,7,0,7,0,0,0.0,0.0,0.0,1.0
1311,All,506301,Santa Clara County,San Jose,1.0,13,3,10,733,7,740,0,7,730,3,1.0,0.6666666666666666,0.0,1.0
1312,2018,506302,Santa Clara County,San Jose,1.0,0,0,0,0,0,0,0,0,0,0,0.0,0.0,0.0,0.0
1313,2019,506302,Santa Clara County,San Jose,1.0,0,0,0,0,0,0,0,0,0,0,0.0,0.0,0.0,0.0
1314,2020,506302,Santa Clara County,San Jose,1.0,1,1,0,61,0,61,0,0,61,0,0.0,0.0,0.0,0.0
1315,2021,506302,Santa Clara County,San Jose,1.0,1,1,0,70,0,70,0,0,70,0,0.0,0.0,0.0,0.0
1316,2022,506302,Santa Clara County,San Jose,1.0,5,0,5,5,0,5,0,0,0,5,0.0,1.0,0.0,0.0
1317,2023,506302,Santa Clara County,San Jose,1.0,8,0,8,8,0,8,0,0,0,8,0.0,0.875,0.0,0.0
1318,2024,506302,Santa Clara County,San Jose,1.0,9,0,9,1,8,9,0,8,0,1,0.0,1.0,0.0,1.0
1319,All,506302,Santa Clara County,San Jose,1.0,24,2,22,145,8,153,0,8,131,14,0.0,0.9285714285714286,0.0,1.0
1320,2018,506304,Santa Clara County,San Jose,1.0,0,0,0,0,0,0,0,0,0,0,0.0,0.0,0.0,0.0
1321,2019,506304,Santa Clara County,San Jose,1.0,0,0,0,0,0,0,0,0,0,0,0.0,0.0,0.0,0.0
1322,2020,506304,Santa Clara County,San Jose,1.0,0,0,0,0,0,0,0,0,0,0,0.0,0.0,0.0,0.0
1323,2021,506304,Santa Clara County,San Jose,1.0,0,0,0,0,0,0,0,0,0,0,0.0,0.0,0.0,0.0
1324,2022,506304,Santa Clara County,San Jose,1.0,0,0,0,0,0,0,0,0,0,0,0.0,0.0,0.0,0.0
1325,2023,506304,Santa Clara County,San Jose,1.0,0,0,0,0,0,0,0,0,0,0,0.0,0.0,0.0,0.0
1326,2024,506304,Santa Clara County,San Jose,1.0,0,0,0,0,0,0,0,0,0,0,0.0,0.0,0.0,0.0
1327,All,506304,Santa Clara County,San Jose,1.0,0,0,0,0,0,0,0,0,0,0,0.0,0.0,0.0,0.0
1328,2018,506305,Santa Clara County,San Jose,1.0,2,2,0,51,0,51,0,0,51,0,1.0,0.0,0.0,0.0
1329,2019,506305,Santa Clara County,San Jose,1.0,0,0,0,0,0,0,0,0,0,0,0.0,0.0,0.0,0.0
1330,2020,506305,Santa Clara County,San Jose,1.0,0,0,0,0,0,0,0,0,0,0,0.0,0.0,0.0,0.0
1331,2021,506305,Santa Clara County,San Jose,1.0,0,0,0,0,0,0,0,0,0,0,0.0,0.0,0.0,0.0
1332,2022,506305,Santa Clara County,San Jose,1.0,3,0,3,3,0,3,0,0,0,3,0.0,1.0,0.0,0.0
1333,2023,506305,Santa Clara County,San Jose,1.0,2,0,2,2,0,2,0,0,0,2,0.0,1.0,0.0,0.0
1334,2024,506305,Santa Clara County,San Jose,1.0,15,0,15,0,15,15,0,15,0,0,0.0,0.0,0.0,1.0
1335,All,506305,Santa Clara County,San Jose,1.0,22,2,20,56,15,71,0,15,51,5,1.0,1.0,0.0,1.0
1336,2018,506401,Santa Clara County,San Jose,1.0,2,2,0,90,0,90,0,0,90,0,1.0,0.0,0.0,0.0
1337,2019,506401,Santa Clara County,San Jose,1.0,2,2,0,99,0,99,0,0,99,0,0.5151515151515151,0.0,0.0,0.0
1338,2020,506401,Santa Clara County,San Jose,1.0,1,1,0,79,0,79,0,0,79,0,0.0,0.0,0.0,0.0
1339,2021,506401,Santa Clara County,San Jose,1.0,0,0,0,0,0,0,0,0,0,0,0.0,0.0,0.0,0.0
1340,2022,506401,Santa Clara County,San Jose,1.0,4,0,4,4,0,4,0,0,0,4,0.0,1.0,0.0,0.0
1341,2023,506401,Santa Clara County,San Jose,1.0,9,1,8,83,0,83,0,0,75,8,1.0,1.0,0.0,0.0
1342,2024,506401,Santa Clara County,San Jose,1.0,5,0,5,1,4,5,0,4,0,1,0.0,1.0,0.0,1.0
1343,All,506401,Santa Clara County,San Jose,1.0,23,6,17,356,4,360,0,4,343,13,0.6297376093294461,1.0,0.0,1.0
1344,2018,506402,Santa Clara County,San Jose,0.606,0,0,0,0,0,0,0,0,0,0,0.0,0.0,0.0,0.0
1345,2019,506402,Santa Clara County,San Jose,0.606,0,0,0,0,0,0,0,0,0,0,0.0,0.0,0.0,0.0
1346,2020,506402,Santa Clara County,San Jose,0.606,0,0,0,0,0,0,0,0,0,0,0.0,0.0,0.0,0.0
1347,2021,506402,Santa Clara County,San Jose,0.606,0,0,0,0,0,0,0,0,0,0,0.0,0.0,0.0,0.0
1348,2022,506402,Santa Clara County,San Jose,0.606,5,1,4,241,0,241,0,0,237,4,1.0,1.0,0.0,0.0
1349,2023,506402,Santa Clara County,San Jose,0.606,6,1,5,7,99,106,99,0,2,5,1.0,1.0,1.0,0.0
1350,2024,506402,Santa Clara County,San Jose,0.606,2,0,2,0,2,2,0,2,0,0,0.0,0.0,0.0,1.0
1351,All,506402,Santa Clara County,San Jose,0.606,13,2,11,248,101,349,99,2,239,9,1.0,1.0,1.0,1.0
1352,2018,506504,Santa Clara County,San Jose,1.0,1,1,0,46,0,46,0,0,46,0,1.0,0.0,0.0,0.0
1353,2019,506504,Santa Clara County,San Jose,1.0,0,0,0,0,0,0,0,0,0,0,0.0,0.0,0.0,0.0
1354,2020,506504,Santa Clara County,San Jose,1.0,1,1,0,46,0,46,0,0,46,0,1.0,0.0,0.0,0.0
1355,2021,506504,Santa Clara County,San Jose,1.0,0,0,0,0,0,0,0,0,0,0,0.0,0.0,0.0,0.0
1356,2022,506504,Santa Clara County,San Jose,1.0,0,0,0,0,0,0,0,0,0,0,0.0,0.0,0.0,0.0
1357,2023,506504,Santa Clara County,San Jose,1.0,0,0,0,0,0,0,0,0,0,0,0.0,0.0,0.0,0.0
1358,2024,506504,Santa Clara County,San Jose,1.0,0,0,0,0,0,0,0,0,0,0,0.0,0.0,0.0,0.0
1359,All,506504,Santa Clara County,San Jose,1.0,2,2,0,92,0,92,0,0,92,0,1.0,0.0,0.0,0.0
1360,2018,506505,Santa Clara County,San Jose,0.712,0,0,0,0,0,0,0,0,0,0,0.0,0.0,0.0,0.0
1361,2019,506505,Santa Clara County,San Jose,0.712,0,0,0,0,0,0,0,0,0,0,0.0,0.0,0.0,0.0
1362,2020,506505,Santa Clara County,San Jose,0.712,0,0,0,0,0,0,0,0,0,0,0.0,0.0,0.0,0.0
1363,2021,506505,Santa Clara County,San Jose,0.712,0,0,0,0,0,0,0,0,0,0,0.0,0.0,0.0,0.0
1364,2022,506505,Santa Clara County,San Jose,0.712,0,0,0,0,0,0,0,0,0,0,0.0,0.0,0.0,0.0
1365,2023,506505,Santa Clara County,San Jose,0.712,1,0,1,1,0,1,0,0,0,1,0.0,1.0,0.0,0.0
1366,2024,506505,Santa Clara County,San Jose,0.712,0,0,0,0,0,0,0,0,0,0,0.0,0.0,0.0,0.0
1367,All,506505,Santa Clara County,San Jose,0.712,1,0,1,1,0,1,0,0,0,1,0.0,1.0,0.0,0.0
1368,2018,506601,Santa Clara County,San Jose,0.827,0,0,0,0,0,0,0,0,0,0,0.0,0.0,0.0,0.0
1369,2019,506601,Santa Clara County,San Jose,0.827,0,0,0,0,0,0,0,0,0,0,0.0,0.0,0.0,0.0
1370,2020,506601,Santa Clara County,San Jose,0.827,0,0,0,0,0,0,0,0,0,0,0.0,0.0,0.0,0.0
1371,2021,506601,Santa Clara County,San Jose,0.827,0,0,0,0,0,0,0,0,0,0,0.0,0.0,0.0,0.0
1372,2022,506601,Santa Clara County,San Jose,0.827,3,0,3,3,0,3,0,0,0,3,0.0,1.0,0.0,0.0
1373,2023,506601,Santa Clara County,San Jose,0.827,2,0,2,2,0,2,0,0,0,2,0.0,1.0,0.0,0.0
1374,2024,506601,Santa Clara County,San Jose,0.827,9,0,9,0,9,9,0,9,0,0,0.0,0.0,0.0,1.0
1375,All,506601,Santa Clara County,San Jose,0.827,14,0,14,5,9,14,0,9,0,5,0.0,1.0,0.0,1.0
1376,2018,506603,Santa Clara County,San Jose,0.728,0,0,0,0,0,0,0,0,0,0,0.0,0.0,0.0,0.0
1377,2019,506603,Santa Clara County,San Jose,0.728,0,0,0,0,0,0,0,0,0,0,0.0,0.0,0.0,0.0
1378,2020,506603,Santa Clara County,San Jose,0.728,0,0,0,0,0,0,0,0,0,0,0.0,0.0,0.0,0.0
1379,2021,506603,Santa Clara County,San Jose,0.728,0,0,0,0,0,0,0,0,0,0,0.0,0.0,0.0,0.0
1380,2022,506603,Santa Clara County,San Jose,0.728,1,0,1,1,0,1,0,0,0,1,0.0,1.0,0.0,0.0
1381,2023,506603,Santa Clara County,San Jose,0.728,1,0,1,1,0,1,0,0,0,1,0.0,1.0,0.0,0.0
1382,2024,506603,Santa Clara County,San Jose,0.728,1,0,1,0,1,1,0,1,0,0,0.0,0.0,0.0,1.0
1383,All,506603,Santa Clara County,San Jose,0.728,3,0,3,2,1,3,0,1,0,2,0.0,1.0,0.0,1.0
1384,2018,506604,Santa Clara County,San Jose,0.835,0,0,0,0,0,0,0,0,0,0,0.0,0.0,0.0,0.0
1385,2019,506604,Santa Clara County,San Jose,0.835,0,0,0,0,0,0,0,0,0,0,0.0,0.0,0.0,0.0
1386,2020,506604,Santa Clara County,San Jose,0.835,1,1,0,741,0,741,0,0,741,0,1.0,0.0,0.0,0.0
1387,2021,506604,Santa Clara County,San Jose,0.835,0,0,0,0,0,0,0,0,0,0,0.0,0.0,0.0,0.0
1388,2022,506604,Santa Clara County,San Jose,0.835,5,1,4,49,0,49,0,0,45,4,1.0,1.0,0.0,0.0
1389,2023,506604,Santa Clara County,San Jose,0.835,4,1,3,870,0,870,0,0,867,3,1.0,1.0,0.0,0.0
1390,2024,506604,Santa Clara County,San Jose,0.835,7,0,7,1,6,7,0,6,0,1,0.0,1.0,0.0,1.0
1391,All,506604,Santa Clara County,San Jose,0.835,17,3,14,1661,6,1667,0,6,1653,8,1.0,1.0,0.0,1.0
1392,2018,506605,Santa Clara County,San Jose,0.844,0,0,0,0,0,0,0,0,0,0,0.0,0.0,0.0,0.0
1393,2019,506605,Santa Clara County,San Jose,0.844,0,0,0,0,0,0,0,0,0,0,0.0,0.0,0.0,0.0
1394,2020,506605,Santa Clara County,San Jose,0.844,0,0,0,0,0,0,0,0,0,0,0.0,0.0,0.0,0.0
1395,2021,506605,Santa Clara County,San Jose,0.844,0,0,0,0,0,0,0,0,0,0,0.0,0.0,0.0,0.0
1396,2022,506605,Santa Clara County,San Jose,0.844,3,0,3,3,0,3,0,0,0,3,0.0,1.0,0.0,0.0
1397,2023,506605,Santa Clara County,San Jose,0.844,1,0,1,1,0,1,0,0,0,1,0.0,1.0,0.0,0.0
1398,2024,506605,Santa Clara County,San Jose,0.844,7,0,7,1,6,7,0,6,0,1,0.0,1.0,0.0,1.0
1399,All,506605,Santa Clara County,San Jose,0.844,11,0,11,5,6,11,0,6,0,5,0.0,1.0,0.0,1.0
1400,2018,506606,Santa Clara County,San Jose,0.151,0,0,0,0,0,0,0,0,0,0,0.0,0.0,0.0,0.0
1401,2019,506606,Santa Clara County,San Jose,0.151,0,0,0,0,0,0,0,0,0,0,0.0,0.0,0.0,0.0
1402,2020,506606,Santa Clara County,San Jose,0.151,0,0,0,0,0,0,0,0,0,0,0.0,0.0,0.0,0.0
1403,2021,506606,Santa Clara County,San Jose,0.151,0,0,0,0,0,0,0,0,0,0,0.0,0.0,0.0,0.0
1404,2022,506606,Santa Clara County,San Jose,0.151,1,0,1,1,0,1,0,0,0,1,0.0,1.0,0.0,0.0
1405,2023,506606,Santa Clara County,San Jose,0.151,1,0,1,1,0,1,0,0,0,1,0.0,1.0,0.0,0.0
1406,2024,506606,Santa Clara County,San Jose,0.151,0,0,0,0,0,0,0,0,0,0,0.0,0.0,0.0,0.0
1407,All,506606,Santa Clara County,San Jose,0.151,2,0,2,2,0,2,0,0,0,2,0.0,1.0,0.0,0.0
1408,2018,506701,Santa Clara County,San Jose,0.281,0,0,0,0,0,0,0,0,0,0,0.0,0.0,0.0,0.0
1409,2019,506701,Santa Clara County,San Jose,0.281,0,0,0,0,0,0,0,0,0,0,0.0,0.0,0.0,0.0
1410,2020,506701,Santa Clara County,San Jose,0.281,0,0,0,0,0,0,0,0,0,0,0.0,0.0,0.0,0.0
1411,2021,506701,Santa Clara County,San Jose,0.281,0,0,0,0,0,0,0,0,0,0,0.0,0.0,0.0,0.0
1412,2022,506701,Santa Clara County,San Jose,0.281,0,0,0,0,0,0,0,0,0,0,0.0,0.0,0.0,0.0
1413,2023,506701,Santa Clara County,San Jose,0.281,0,0,0,0,0,0,0,0,0,0,0.0,0.0,0.0,0.0
1414,2024,506701,Santa Clara County,San Jose,0.281,0,0,0,0,0,0,0,0,0,0,0.0,0.0,0.0,0.0
1415,All,506701,Santa Clara County,San Jose,0.281,0,0,0,0,0,0,0,0,0,0,0.0,0.0,0.0,0.0
1416,2018,506802,Santa Clara County,San Jose,0.886,0,0,0,0,0,0,0,0,0,0,0.0,0.0,0.0,0.0
1417,2019,506802,Santa Clara County,San Jose,0.886,0,0,0,0,0,0,0,0,0,0,0.0,0.0,0.0,0.0
1418,2020,506802,Santa Clara County,San Jose,0.886,0,0,0,0,0,0,0,0,0,0,0.0,0.0,0.0,0.0
1419,2021,506802,Santa Clara County,San Jose,0.886,0,0,0,0,0,0,0,0,0,0,0.0,0.0,0.0,0.0
1420,2022,506802,Santa Clara County,San Jose,0.886,9,0,9,9,0,9,0,0,0,9,0.0,1.0,0.0,0.0
1421,2023,506802,Santa Clara County,San Jose,0.886,7,0,7,8,0,8,0,0,0,8,0.0,1.0,0.0,0.0
1422,2024,506802,Santa Clara County,San Jose,0.886,6,0,6,1,5,6,0,5,0,1,0.0,1.0,0.0,1.0
1423,All,506802,Santa Clara County,San Jose,0.886,22,0,22,18,5,23,0,5,0,18,0.0,1.0,0.0,1.0
1424,2018,506803,Santa Clara County,San Jose,1.0,0,0,0,0,0,0,0,0,0,0,0.0,0.0,0.0,0.0
1425,2019,506803,Santa Clara County,San Jose,1.0,0,0,0,0,0,0,0,0,0,0,0.0,0.0,0.0,0.0
1426,2020,506803,Santa Clara County,San Jose,1.0,0,0,0,0,0,0,0,0,0,0,0.0,0.0,0.0,0.0
1427,2021,506803,Santa Clara County,San Jose,1.0,0,0,0,0,0,0,0,0,0,0,0.0,0.0,0.0,0.0
1428,2022,506803,Santa Clara County,San Jose,1.0,3,0,3,3,0,3,0,0,0,3,0.0,1.0,0.0,0.0
1429,2023,506803,Santa Clara County,San Jose,1.0,2,0,2,2,0,2,0,0,0,2,0.0,1.0,0.0,0.0
1430,2024,506803,Santa Clara County,San Jose,1.0,3,0,3,0,3,3,0,3,0,0,0.0,0.0,0.0,1.0
1431,All,506803,Santa Clara County,San Jose,1.0,8,0,8,5,3,8,0,3,0,5,0.0,1.0,0.0,1.0
1432,2018,506804,Santa Clara County,San Jose,0.39,0,0,0,0,0,0,0,0,0,0,0.0,0.0,0.0,0.0
1433,2019,506804,Santa Clara County,San Jose,0.39,0,0,0,0,0,0,0,0,0,0,0.0,0.0,0.0,0.0
1434,2020,506804,Santa Clara County,San Jose,0.39,0,0,0,0,0,0,0,0,0,0,0.0,0.0,0.0,0.0
1435,2021,506804,Santa Clara County,San Jose,0.39,0,0,0,0,0,0,0,0,0,0,0.0,0.0,0.0,0.0
1436,2022,506804,Santa Clara County,San Jose,0.39,2,0,2,2,0,2,0,0,0,2,0.0,0.5,0.0,0.0
1437,2023,506804,Santa Clara County,San Jose,0.39,2,0,2,2,0,2,0,0,0,2,0.0,1.0,0.0,0.0
1438,2024,506804,Santa Clara County,San Jose,0.39,1,0,1,0,1,1,0,1,0,0,0.0,0.0,0.0,1.0
1439,All,506804,Santa Clara County,San Jose,0.39,5,0,5,4,1,5,0,1,0,4,0.0,0.75,0.0,1.0
1440,2018,506900,Santa Clara County,San Jose,0.08,0,0,0,0,0,0,0,0,0,0,0.0,0.0,0.0,0.0
1441,2019,506900,Santa Clara County,San Jose,0.08,0,0,0,0,0,0,0,0,0,0,0.0,0.0,0.0,0.0
1442,2020,506900,Santa Clara County,San Jose,0.08,0,0,0,0,0,0,0,0,0,0,0.0,0.0,0.0,0.0
1443,2021,506900,Santa Clara County,San Jose,0.08,0,0,0,0,0,0,0,0,0,0,0.0,0.0,0.0,0.0
1444,2022,506900,Santa Clara County,San Jose,0.08,0,0,0,0,0,0,0,0,0,0,0.0,0.0,0.0,0.0
1445,2023,506900,Santa Clara County,San Jose,0.08,1,0,1,1,0,1,0,0,0,1,0.0,1.0,0.0,0.0
1446,2024,506900,Santa Clara County,San Jose,0.08,0,0,0,0,0,0,0,0,0,0,0.0,0.0,0.0,0.0
1447,All,506900,Santa Clara County,San Jose,0.08,1,0,1,1,0,1,0,0,0,1,0.0,1.0,0.0,0.0
1448,2018,507402,Santa Clara County,San Jose,0.022,0,0,0,0,0,0,0,0,0,0,0.0,0.0,0.0,0.0
1449,2019,507402,Santa Clara County,San Jose,0.022,0,0,0,0,0,0,0,0,0,0,0.0,0.0,0.0,0.0
1450,2020,507402,Santa Clara County,San Jose,0.022,0,0,0,0,0,0,0,0,0,0,0.0,0.0,0.0,0.0
1451,2021,507402,Santa Clara County,San Jose,0.022,0,0,0,0,0,0,0,0,0,0,0.0,0.0,0.0,0.0
1452,2022,507402,Santa Clara County,San Jose,0.022,0,0,0,0,0,0,0,0,0,0,0.0,0.0,0.0,0.0
1453,2023,507402,Santa Clara County,San Jose,0.022,0,0,0,0,0,0,0,0,0,0,0.0,0.0,0.0,0.0
1454,2024,507402,Santa Clara County,San Jose,0.022,0,0,0,0,0,0,0,0,0,0,0.0,0.0,0.0,0.0
1455,All,507402,Santa Clara County,San Jose,0.022,0,0,0,0,0,0,0,0,0,0,0.0,0.0,0.0,0.0
1456,2018,507807,Santa Clara County,San Jose,0.061,0,0,0,0,0,0,0,0,0,0,0.0,0.0,0.0,0.0
1457,2019,507807,Santa Clara County,San Jose,0.061,0,0,0,0,0,0,0,0,0,0,0.0,0.0,0.0,0.0
1458,2020,507807,Santa Clara County,San Jose,0.061,0,0,0,0,0,0,0,0,0,0,0.0,0.0,0.0,0.0
1459,2021,507807,Santa Clara County,San Jose,0.061,0,0,0,0,0,0,0,0,0,0,0.0,0.0,0.0,0.0
1460,2022,507807,Santa Clara County,San Jose,0.061,0,0,0,0,0,0,0,0,0,0,0.0,0.0,0.0,0.0
1461,2023,507807,Santa Clara County,San Jose,0.061,0,0,0,0,0,0,0,0,0,0,0.0,0.0,0.0,0.0
1462,2024,507807,Santa Clara County,San Jose,0.061,0,0,0,0,0,0,0,0,0,0,0.0,0.0,0.0,0.0
1463,All,507807,Santa Clara County,San Jose,0.061,0,0,0,0,0,0,0,0,0,0,0.0,0.0,0.0,0.0
1464,2018,507808,Santa Clara County,San Jose,0.047,0,0,0,0,0,0,0,0,0,0,0.0,0.0,0.0,0.0
1465,2019,507808,Santa Clara County,San Jose,0.047,0,0,0,0,0,0,0,0,0,0,0.0,0.0,0.0,0.0
1466,2020,507808,Santa Clara County,San Jose,0.047,0,0,0,0,0,0,0,0,0,0,0.0,0.0,0.0,0.0
1467,2021,507808,Santa Clara County,San Jose,0.047,0,0,0,0,0,0,0,0,0,0,0.0,0.0,0.0,0.0
1468,2022,507808,Santa Clara County,San Jose,0.047,0,0,0,0,0,0,0,0,0,0,0.0,0.0,0.0,0.0
1469,2023,507808,Santa Clara County,San Jose,0.047,0,0,0,0,0,0,0,0,0,0,0.0,0.0,0.0,0.0
1470,2024,507808,Santa Clara County,San Jose,0.047,0,0,0,0,0,0,0,0,0,0,0.0,0.0,0.0,0.0
1471,All,507808,Santa Clara County,San Jose,0.047,0,0,0,0,0,0,0,0,0,0,0.0,0.0,0.0,0.0
1472,2018,507903,Santa Clara County,San Jose,1.0,0,0,0,0,0,0,0,0,0,0,0.0,0.0,0.0,0.0
1473,2019,507903,Santa Clara County,San Jose,1.0,0,0,0,0,0,0,0,0,0,0,0.0,0.0,0.0,0.0
1474,2020,507903,Santa Clara County,San Jose,1.0,0,0,0,0,0,0,0,0,0,0,0.0,0.0,0.0,0.0
1475,2021,507903,Santa Clara County,San Jose,1.0,1,0,1,6,0,6,0,0,0,6,0.0,0.0,0.0,0.0
1476,2022,507903,Santa Clara County,San Jose,1.0,5,0,5,5,0,5,0,0,0,5,0.0,1.0,0.0,0.0
1477,2023,507903,Santa Clara County,San Jose,1.0,3,0,3,3,0,3,0,0,0,3,0.0,1.0,0.0,0.0
1478,2024,507903,Santa Clara County,San Jose,1.0,3,0,3,1,2,3,0,2,0,1,0.0,0.0,0.0,1.0
1479,All,507903,Santa Clara County,San Jose,1.0,12,0,12,15,2,17,0,2,0,15,0.0,0.5333333333333333,0.0,1.0
1480,2018,507904,Santa Clara County,San Jose,0.881,0,0,0,0,0,0,0,0,0,0,0.0,0.0,0.0,0.0
1481,2019,507904,Santa Clara County,San Jose,0.881,0,0,0,0,0,0,0,0,0,0,0.0,0.0,0.0,0.0
1482,2020,507904,Santa Clara County,San Jose,0.881,0,0,0,0,0,0,0,0,0,0,0.0,0.0,0.0,0.0
1483,2021,507904,Santa Clara County,San Jose,0.881,0,0,0,0,0,0,0,0,0,0,0.0,0.0,0.0,0.0
1484,2022,507904,Santa Clara County,San Jose,0.881,3,0,3,3,0,3,0,0,0,3,0.0,1.0,0.0,0.0
1485,2023,507904,Santa Clara County,San Jose,0.881,2,0,2,2,0,2,0,0,0,2,0.0,1.0,0.0,0.0
1486,2024,507904,Santa Clara County,San Jose,0.881,1,0,1,1,0,1,0,0,0,1,0.0,1.0,0.0,0.0
1487,All,507904,Santa Clara County,San Jose,0.881,6,0,6,6,0,6,0,0,0,6,0.0,1.0,0.0,0.0
1488,2018,507905,Santa Clara County,San Jose,1.0,0,0,0,0,0,0,0,0,0,0,0.0,0.0,0.0,0.0
1489,2019,507905,Santa Clara County,San Jose,1.0,0,0,0,0,0,0,0,0,0,0,0.0,0.0,0.0,0.0
1490,2020,507905,Santa Clara County,San Jose,1.0,0,0,0,0,0,0,0,0,0,0,0.0,0.0,0.0,0.0
1491,2021,507905,Santa Clara County,San Jose,1.0,1,1,0,85,0,85,0,0,85,0,1.0,0.0,0.0,0.0
1492,2022,507905,Santa Clara County,San Jose,1.0,0,0,0,0,0,0,0,0,0,0,0.0,0.0,0.0,0.0
1493,2023,507905,Santa Clara County,San Jose,1.0,1,0,1,1,0,1,0,0,0,1,0.0,1.0,0.0,0.0
1494,2024,507905,Santa Clara County,San Jose,1.0,0,0,0,0,0,0,0,0,0,0,0.0,0.0,0.0,0.0
1495,All,507905,Santa Clara County,San Jose,1.0,2,1,1,86,0,86,0,0,85,1,1.0,1.0,0.0,0.0
1496,2018,507906,Santa Clara County,San Jose,1.0,0,0,0,0,0,0,0,0,0,0,0.0,0.0,0.0,0.0
1497,2019,507906,Santa Clara County,San Jose,1.0,0,0,0,0,0,0,0,0,0,0,0.0,0.0,0.0,0.0
1498,2020,507906,Santa Clara County,San Jose,1.0,0,0,0,0,0,0,0,0,0,0,0.0,0.0,0.0,0.0
1499,2021,507906,Santa Clara County,San Jose,1.0,0,0,0,0,0,0,0,0,0,0,0.0,0.0,0.0,0.0
1500,2022,507906,Santa Clara County,San Jose,1.0,7,0,7,7,0,7,0,0,0,7,0.0,1.0,0.0,0.0
1501,2023,507906,Santa Clara County,San Jose,1.0,3,0,3,3,0,3,0,0,0,3,0.0,1.0,0.0,0.0
1502,2024,507906,Santa Clara County,San Jose,1.0,8,0,8,4,4,8,0,4,0,4,0.0,0.75,0.0,1.0
1503,All,507906,Santa Clara County,San Jose,1.0,18,0,18,14,4,18,0,4,0,14,0.0,0.9285714285714286,0.0,1.0
1504,2018,508004,Santa Clara County,San Jose,0.17,0,0,0,0,0,0,0,0,0,0,0.0,0.0,0.0,0.0
1505,2019,508004,Santa Clara County,San Jose,0.17,0,0,0,0,0,0,0,0,0,0,0.0,0.0,0.0,0.0
1506,2020,508004,Santa Clara County,San Jose,0.17,0,0,0,0,0,0,0,0,0,0,0.0,0.0,0.0,0.0
1507,2021,508004,Santa Clara County,San Jose,0.17,0,0,0,0,0,0,0,0,0,0,0.0,0.0,0.0,0.0
1508,2022,508004,Santa Clara County,San Jose,0.17,0,0,0,0,0,0,0,0,0,0,0.0,0.0,0.0,0.0
1509,2023,508004,Santa Clara County,San Jose,0.17,0,0,0,0,0,0,0,0,0,0,0.0,0.0,0.0,0.0
1510,2024,508004,Santa Clara County,San Jose,0.17,0,0,0,0,0,0,0,0,0,0,0.0,0.0,0.0,0.0
1511,All,508004,Santa Clara County,San Jose,0.17,0,0,0,0,0,0,0,0,0,0,0.0,0.0,0.0,0.0
1512,2018,511905,Santa Clara County,San Jose,1.0,0,0,0,0,0,0,0,0,0,0,0.0,0.0,0.0,0.0
1513,2019,511905,Santa Clara County,San Jose,1.0,1,0,1,6,0,6,0,0,0,6,0.0,0.0,0.0,0.0
1514,2020,511905,Santa Clara County,San Jose,1.0,0,0,0,0,0,0,0,0,0,0,0.0,0.0,0.0,0.0
1515,2021,511905,Santa Clara County,San Jose,1.0,0,0,0,0,0,0,0,0,0,0,0.0,0.0,0.0,0.0
1516,2022,511905,Santa Clara County,San Jose,1.0,1,0,1,1,0,1,0,0,0,1,0.0,1.0,0.0,0.0
1517,2023,511905,Santa Clara County,San Jose,1.0,1,0,1,1,0,1,0,0,0,1,0.0,1.0,0.0,0.0
1518,2024,511905,Santa Clara County,San Jose,1.0,3,0,3,0,3,3,0,3,0,0,0.0,0.0,0.0,1.0
1519,All,511905,Santa Clara County,San Jose,1.0,6,0,6,8,3,11,0,3,0,8,0.0,0.25,0.0,1.0
1520,2018,511907,Santa Clara County,San Jose,1.0,0,0,0,0,0,0,0,0,0,0,0.0,0.0,0.0,0.0
1521,2019,511907,Santa Clara County,San Jose,1.0,0,0,0,0,0,0,0,0,0,0,0.0,0.0,0.0,0.0
1522,2020,511907,Santa Clara County,San Jose,1.0,0,0,0,0,0,0,0,0,0,0,0.0,0.0,0.0,0.0
1523,2021,511907,Santa Clara County,San Jose,1.0,1,0,1,21,0,21,0,0,0,21,0.0,0.0,0.0,0.0
1524,2022,511907,Santa Clara County,San Jose,1.0,1,0,1,1,0,1,0,0,0,1,0.0,1.0,0.0,0.0
1525,2023,511907,Santa Clara County,San Jose,1.0,0,0,0,0,0,0,0,0,0,0,0.0,0.0,0.0,0.0
1526,2024,511907,Santa Clara County,San Jose,1.0,0,0,0,0,0,0,0,0,0,0,0.0,0.0,0.0,0.0
1527,All,511907,Santa Clara County,San Jose,1.0,2,0,2,22,0,22,0,0,0,22,0.0,0.045454545454545456,0.0,0.0
1528,2018,511910,Santa Clara County,San Jose,1.0,0,0,0,0,0,0,0,0,0,0,0.0,0.0,0.0,0.0
1529,2019,511910,Santa Clara County,San Jose,1.0,0,0,0,0,0,0,0,0,0,0,0.0,0.0,0.0,0.0
1530,2020,511910,Santa Clara County,San Jose,1.0,0,0,0,0,0,0,0,0,0,0,0.0,0.0,0.0,0.0
1531,2021,511910,Santa Clara County,San Jose,1.0,0,0,0,0,0,0,0,0,0,0,0.0,0.0,0.0,0.0
1532,2022,511910,Santa Clara County,San Jose,1.0,0,0,0,0,0,0,0,0,0,0,0.0,0.0,0.0,0.0
1533,2023,511910,Santa Clara County,San Jose,1.0,0,0,0,0,0,0,0,0,0,0,0.0,0.0,0.0,0.0
1534,2024,511910,Santa Clara County,San Jose,1.0,4,0,4,0,4,4,0,4,0,0,0.0,0.0,0.0,1.0
1535,All,511910,Santa Clara County,San Jose,1.0,4,0,4,0,4,4,0,4,0,0,0.0,0.0,0.0,1.0
1536,2018,511911,Santa Clara County,San Jose,0.318,0,0,0,0,0,0,0,0,0,0,0.0,0.0,0.0,0.0
1537,2019,511911,Santa Clara County,San Jose,0.318,0,0,0,0,0,0,0,0,0,0,0.0,0.0,0.0,0.0
1538,2020,511911,Santa Clara County,San Jose,0.318,0,0,0,0,0,0,0,0,0,0,0.0,0.0,0.0,0.0
1539,2021,511911,Santa Clara County,San Jose,0.318,0,0,0,0,0,0,0,0,0,0,0.0,0.0,0.0,0.0
1540,2022,511911,Santa Clara County,San Jose,0.318,0,0,0,0,0,0,0,0,0,0,0.0,0.0,0.0,0.0
1541,2023,511911,Santa Clara County,San Jose,0.318,6,0,6,6,0,6,0,0,0,6,0.0,0.3333333333333333,0.0,0.0
1542,2024,511911,Santa Clara County,San Jose,0.318,8,0,8,7,1,8,0,1,0,7,0.0,0.0,0.0,1.0
1543,All,511911,Santa Clara County,San Jose,0.318,14,0,14,13,1,14,0,1,0,13,0.0,0.15384615384615385,0.0,1.0
1544,2018,511912,Santa Clara County,San Jose,0.905,0,0,0,0,0,0,0,0,0,0,0.0,0.0,0.0,0.0
1545,2019,511912,Santa Clara County,San Jose,0.905,0,0,0,0,0,0,0,0,0,0,0.0,0.0,0.0,0.0
1546,2020,511912,Santa Clara County,San Jose,0.905,0,0,0,0,0,0,0,0,0,0,0.0,0.0,0.0,0.0
1547,2021,511912,Santa Clara County,San Jose,0.905,0,0,0,0,0,0,0,0,0,0,0.0,0.0,0.0,0.0
1548,2022,511912,Santa Clara County,San Jose,0.905,4,0,4,4,0,4,0,0,0,4,0.0,1.0,0.0,0.0
1549,2023,511912,Santa Clara County,San Jose,0.905,24,0,24,24,0,24,0,0,0,24,0.0,0.375,0.0,0.0
1550,2024,511912,Santa Clara County,San Jose,0.905,2,0,2,0,2,2,0,2,0,0,0.0,0.0,0.0,1.0
1551,All,511912,Santa Clara County,San Jose,0.905,30,0,30,28,2,30,0,2,0,28,0.0,0.4642857142857143,0.0,1.0
1552,2018,511913,Santa Clara County,San Jose,1.0,0,0,0,0,0,0,0,0,0,0,0.0,0.0,0.0,0.0
1553,2019,511913,Santa Clara County,San Jose,1.0,0,0,0,0,0,0,0,0,0,0,0.0,0.0,0.0,0.0
1554,2020,511913,Santa Clara County,San Jose,1.0,0,0,0,0,0,0,0,0,0,0,0.0,0.0,0.0,0.0
1555,2021,511913,Santa Clara County,San Jose,1.0,0,0,0,0,0,0,0,0,0,0,0.0,0.0,0.0,0.0
1556,2022,511913,Santa Clara County,San Jose,1.0,1,0,1,1,0,1,0,0,0,1,0.0,1.0,0.0,0.0
1557,2023,511913,Santa Clara County,San Jose,1.0,6,0,6,6,0,6,0,0,0,6,0.0,1.0,0.0,0.0
1558,2024,511913,Santa Clara County,San Jose,1.0,1,0,1,0,1,1,0,1,0,0,0.0,0.0,0.0,1.0
1559,All,511913,Santa Clara County,San Jose,1.0,8,0,8,7,1,8,0,1,0,7,0.0,1.0,0.0,1.0
1560,2018,511914,Santa Clara County,San Jose,1.0,0,0,0,0,0,0,0,0,0,0,0.0,0.0,0.0,0.0
1561,2019,511914,Santa Clara County,San Jose,1.0,0,0,0,0,0,0,0,0,0,0,0.0,0.0,0.0,0.0
1562,2020,511914,Santa Clara County,San Jose,1.0,0,0,0,0,0,0,0,0,0,0,0.0,0.0,0.0,0.0
1563,2021,511914,Santa Clara County,San Jose,1.0,0,0,0,0,0,0,0,0,0,0,0.0,0.0,0.0,0.0
1564,2022,511914,Santa Clara County,San Jose,1.0,2,0,2,2,0,2,0,0,0,2,0.0,1.0,0.0,0.0
1565,2023,511914,Santa Clara County,San Jose,1.0,3,0,3,3,0,3,0,0,0,3,0.0,1.0,0.0,0.0
1566,2024,511914,Santa Clara County,San Jose,1.0,1,0,1,0,1,1,0,1,0,0,0.0,0.0,0.0,1.0
1567,All,511914,Santa Clara County,San Jose,1.0,6,0,6,5,1,6,0,1,0,5,0.0,1.0,0.0,1.0
1568,2018,511915,Santa Clara County,San Jose,1.0,0,0,0,0,0,0,0,0,0,0,0.0,0.0,0.0,0.0
1569,2019,511915,Santa Clara County,San Jose,1.0,1,1,0,1,45,46,45,0,1,0,1.0,0.0,1.0,0.0
1570,2020,511915,Santa Clara County,San Jose,1.0,0,0,0,0,0,0,0,0,0,0,0.0,0.0,0.0,0.0
1571,2021,511915,Santa Clara County,San Jose,1.0,0,0,0,0,0,0,0,0,0,0,0.0,0.0,0.0,0.0
1572,2022,511915,Santa Clara County,San Jose,1.0,4,0,4,4,0,4,0,0,0,4,0.0,1.0,0.0,0.0
1573,2023,511915,Santa Clara County,San Jose,1.0,0,0,0,0,0,0,0,0,0,0,0.0,0.0,0.0,0.0
1574,2024,511915,Santa Clara County,San Jose,1.0,0,0,0,0,0,0,0,0,0,0,0.0,0.0,0.0,0.0
1575,All,511915,Santa Clara County,San Jose,1.0,5,1,4,5,45,50,45,0,1,4,1.0,1.0,1.0,0.0
1576,2018,511916,Santa Clara County,San Jose,1.0,0,0,0,0,0,0,0,0,0,0,0.0,0.0,0.0,0.0
1577,2019,511916,Santa Clara County,San Jose,1.0,0,0,0,0,0,0,0,0,0,0,0.0,0.0,0.0,0.0
1578,2020,511916,Santa Clara County,San Jose,1.0,0,0,0,0,0,0,0,0,0,0,0.0,0.0,0.0,0.0
1579,2021,511916,Santa Clara County,San Jose,1.0,0,0,0,0,0,0,0,0,0,0,0.0,0.0,0.0,0.0
1580,2022,511916,Santa Clara County,San Jose,1.0,1,0,1,1,0,1,0,0,0,1,0.0,1.0,0.0,0.0
1581,2023,511916,Santa Clara County,San Jose,1.0,2,0,2,2,0,2,0,0,0,2,0.0,0.5,0.0,0.0
1582,2024,511916,Santa Clara County,San Jose,1.0,1,0,1,1,0,1,0,0,0,1,0.0,1.0,0.0,0.0
1583,All,511916,Santa Clara County,San Jose,1.0,4,0,4,4,0,4,0,0,0,4,0.0,0.75,0.0,0.0
1584,2018,511917,Santa Clara County,San Jose,0.973,1,0,1,1,0,1,0,0,0,1,0.0,0.0,0.0,0.0
1585,2019,511917,Santa Clara County,San Jose,0.973,0,0,0,0,0,0,0,0,0,0,0.0,0.0,0.0,0.0
1586,2020,511917,Santa Clara County,San Jose,0.973,0,0,0,0,0,0,0,0,0,0,0.0,0.0,0.0,0.0
1587,2021,511917,Santa Clara County,San Jose,0.973,0,0,0,0,0,0,0,0,0,0,0.0,0.0,0.0,0.0
1588,2022,511917,Santa Clara County,San Jose,0.973,0,0,0,0,0,0,0,0,0,0,0.0,0.0,0.0,0.0
1589,2023,511917,Santa Clara County,San Jose,0.973,2,1,1,3,0,3,0,0,2,1,0.0,1.0,0.0,0.0
1590,2024,511917,Santa Clara County,San Jose,0.973,0,0,0,0,0,0,0,0,0,0,0.0,0.0,0.0,0.0
1591,All,511917,Santa Clara County,San Jose,0.973,3,1,2,4,0,4,0,0,2,2,0.0,0.5,0.0,0.0
1592,2018,511918,Santa Clara County,San Jose,0.161,0,0,0,0,0,0,0,0,0,0,0.0,0.0,0.0,0.0
1593,2019,511918,Santa Clara County,San Jose,0.161,0,0,0,0,0,0,0,0,0,0,0.0,0.0,0.0,0.0
1594,2020,511918,Santa Clara County,San Jose,0.161,0,0,0,0,0,0,0,0,0,0,0.0,0.0,0.0,0.0
1595,2021,511918,Santa Clara County,San Jose,0.161,0,0,0,0,0,0,0,0,0,0,0.0,0.0,0.0,0.0
1596,2022,511918,Santa Clara County,San Jose,0.161,0,0,0,0,0,0,0,0,0,0,0.0,0.0,0.0,0.0
1597,2023,511918,Santa Clara County,San Jose,0.161,1,0,1,1,0,1,0,0,0,1,0.0,1.0,0.0,0.0
1598,2024,511918,Santa Clara County,San Jose,0.161,3,0,3,1,2,3,0,2,0,1,0.0,0.0,0.0,1.0
1599,All,511918,Santa Clara County,San Jose,0.161,4,0,4,2,2,4,0,2,0,2,0.0,0.5,0.0,1.0
1600,2018,512001,Santa Clara County,San Jose,0.817,1,0,1,1,0,1,0,0,0,1,0.0,0.0,0.0,0.0
1601,2019,512001,Santa Clara County,San Jose,0.817,0,0,0,0,0,0,0,0,0,0,0.0,0.0,0.0,0.0
1602,2020,512001,Santa Clara County,San Jose,0.817,0,0,0,0,0,0,0,0,0,0,0.0,0.0,0.0,0.0
1603,2021,512001,Santa Clara County,San Jose,0.817,0,0,0,0,0,0,0,0,0,0,0.0,0.0,0.0,0.0
1604,2022,512001,Santa Clara County,San Jose,0.817,3,2,1,7,80,87,80,0,6,1,1.0,1.0,1.0,0.0
1605,2023,512001,Santa Clara County,San Jose,0.817,1,0,1,1,0,1,0,0,0,1,0.0,1.0,0.0,0.0
1606,2024,512001,Santa Clara County,San Jose,0.817,1,0,1,0,1,1,0,1,0,0,0.0,0.0,0.0,1.0
1607,All,512001,Santa Clara County,San Jose,0.817,6,2,4,9,81,90,80,1,6,3,1.0,0.6666666666666666,1.0,1.0
1608,2018,512005,Santa Clara County,San Jose,1.0,0,0,0,0,0,0,0,0,0,0,0.0,0.0,0.0,0.0
1609,2019,512005,Santa Clara County,San Jose,1.0,0,0,0,0,0,0,0,0,0,0,0.0,0.0,0.0,0.0
1610,2020,512005,Santa Clara County,San Jose,1.0,0,0,0,0,0,0,0,0,0,0,0.0,0.0,0.0,0.0
1611,2021,512005,Santa Clara County,San Jose,1.0,0,0,0,0,0,0,0,0,0,0,0.0,0.0,0.0,0.0
1612,2022,512005,Santa Clara County,San Jose,1.0,3,0,3,3,0,3,0,0,0,3,0.0,1.0,0.0,0.0
1613,2023,512005,Santa Clara County,San Jose,1.0,3,1,2,4,0,4,0,0,2,2,0.0,1.0,0.0,0.0
1614,2024,512005,Santa Clara County,San Jose,1.0,5,1,4,1,250,251,203,47,0,1,0.0,1.0,1.0,0.0425531914893617
1615,All,512005,Santa Clara County,San Jose,1.0,11,2,9,8,250,258,203,47,2,6,0.0,1.0,1.0,0.0425531914893617
1616,2018,512019,Santa Clara County,San Jose,1.0,0,0,0,0,0,0,0,0,0,0,0.0,0.0,0.0,0.0
1617,2019,512019,Santa Clara County,San Jose,1.0,0,0,0,0,0,0,0,0,0,0,0.0,0.0,0.0,0.0
1618,2020,512019,Santa Clara County,San Jose,1.0,0,0,0,0,0,0,0,0,0,0,0.0,0.0,0.0,0.0
1619,2021,512019,Santa Clara County,San Jose,1.0,0,0,0,0,0,0,0,0,0,0,0.0,0.0,0.0,0.0
1620,2022,512019,Santa Clara County,San Jose,1.0,0,0,0,0,0,0,0,0,0,0,0.0,0.0,0.0,0.0
1621,2023,512019,Santa Clara County,San Jose,1.0,1,0,1,1,0,1,0,0,0,1,0.0,1.0,0.0,0.0
1622,2024,512019,Santa Clara County,San Jose,1.0,1,0,1,0,1,1,0,1,0,0,0.0,0.0,0.0,1.0
1623,All,512019,Santa Clara County,San Jose,1.0,2,0,2,1,1,2,0,1,0,1,0.0,1.0,0.0,1.0
1624,2018,512021,Santa Clara County,San Jose,1.0,0,0,0,0,0,0,0,0,0,0,0.0,0.0,0.0,0.0
1625,2019,512021,Santa Clara County,San Jose,1.0,0,0,0,0,0,0,0,0,0,0,0.0,0.0,0.0,0.0
1626,2020,512021,Santa Clara County,San Jose,1.0,0,0,0,0,0,0,0,0,0,0,0.0,0.0,0.0,0.0
1627,2021,512021,Santa Clara County,San Jose,1.0,0,0,0,0,0,0,0,0,0,0,0.0,0.0,0.0,0.0
1628,2022,512021,Santa Clara County,San Jose,1.0,3,0,3,3,0,3,0,0,0,3,0.0,1.0,0.0,0.0
1629,2023,512021,Santa Clara County,San Jose,1.0,6,0,6,6,0,6,0,0,0,6,0.0,1.0,0.0,0.0
1630,2024,512021,Santa Clara County,San Jose,1.0,9,0,9,5,4,9,0,4,0,5,0.0,1.0,0.0,1.0
1631,All,512021,Santa Clara County,San Jose,1.0,18,0,18,14,4,18,0,4,0,14,0.0,1.0,0.0,1.0
1632,2018,512022,Santa Clara County,San Jose,1.0,0,0,0,0,0,0,0,0,0,0,0.0,0.0,0.0,0.0
1633,2019,512022,Santa Clara County,San Jose,1.0,0,0,0,0,0,0,0,0,0,0,0.0,0.0,0.0,0.0
1634,2020,512022,Santa Clara County,San Jose,1.0,0,0,0,0,0,0,0,0,0,0,0.0,0.0,0.0,0.0
1635,2021,512022,Santa Clara County,San Jose,1.0,0,0,0,0,0,0,0,0,0,0,0.0,0.0,0.0,0.0
1636,2022,512022,Santa Clara County,San Jose,1.0,1,0,1,1,0,1,0,0,0,1,0.0,1.0,0.0,0.0
1637,2023,512022,Santa Clara County,San Jose,1.0,2,0,2,2,0,2,0,0,0,2,0.0,1.0,0.0,0.0
1638,2024,512022,Santa Clara County,San Jose,1.0,2,0,2,0,2,2,0,2,0,0,0.0,0.0,0.0,1.0
1639,All,512022,Santa Clara County,San Jose,1.0,5,0,5,3,2,5,0,2,0,3,0.0,1.0,0.0,1.0
1640,2018,512023,Santa Clara County,San Jose,1.0,1,1,0,0,147,147,147,0,0,0,0.0,0.0,1.0,0.0
1641,2019,512023,Santa Clara County,San Jose,1.0,0,0,0,0,0,0,0,0,0,0,0.0,0.0,0.0,0.0
1642,2020,512023,Santa Clara County,San Jose,1.0,0,0,0,0,0,0,0,0,0,0,0.0,0.0,0.0,0.0
1643,2021,512023,Santa Clara County,San Jose,1.0,0,0,0,0,0,0,0,0,0,0,0.0,0.0,0.0,0.0
1644,2022,512023,Santa Clara County,San Jose,1.0,3,0,3,3,0,3,0,0,0,3,0.0,1.0,0.0,0.0
1645,2023,512023,Santa Clara County,San Jose,1.0,0,0,0,0,0,0,0,0,0,0,0.0,0.0,0.0,0.0
1646,2024,512023,Santa Clara County,San Jose,1.0,1,0,1,11,0,11,0,0,0,11,0.0,0.0,0.0,0.0
1647,All,512023,Santa Clara County,San Jose,1.0,5,1,4,14,147,161,147,0,0,14,0.0,0.21428571428571427,1.0,0.0
1648,2018,512024,Santa Clara County,San Jose,1.0,0,0,0,0,0,0,0,0,0,0,0.0,0.0,0.0,0.0
1649,2019,512024,Santa Clara County,San Jose,1.0,0,0,0,0,0,0,0,0,0,0,0.0,0.0,0.0,0.0
1650,2020,512024,Santa Clara County,San Jose,1.0,0,0,0,0,0,0,0,0,0,0,0.0,0.0,0.0,0.0
1651,2021,512024,Santa Clara County,San Jose,1.0,0,0,0,0,0,0,0,0,0,0,0.0,0.0,0.0,0.0
1652,2022,512024,Santa Clara County,San Jose,1.0,1,0,1,1,0,1,0,0,0,1,0.0,1.0,0.0,0.0
1653,2023,512024,Santa Clara County,San Jose,1.0,2,0,2,2,0,2,0,0,0,2,0.0,1.0,0.0,0.0
1654,2024,512024,Santa Clara County,San Jose,1.0,5,1,4,1,4,5,0,4,1,0,1.0,0.0,0.0,1.0
1655,All,512024,Santa Clara County,San Jose,1.0,8,1,7,4,4,8,0,4,1,3,1.0,1.0,0.0,1.0
1656,2018,512025,Santa Clara County,San Jose,1.0,0,0,0,0,0,0,0,0,0,0,0.0,0.0,0.0,0.0
1657,2019,512025,Santa Clara County,San Jose,1.0,0,0,0,0,0,0,0,0,0,0,0.0,0.0,0.0,0.0
1658,2020,512025,Santa Clara County,San Jose,1.0,0,0,0,0,0,0,0,0,0,0,0.0,0.0,0.0,0.0
1659,2021,512025,Santa Clara County,San Jose,1.0,0,0,0,0,0,0,0,0,0,0,0.0,0.0,0.0,0.0
1660,2022,512025,Santa Clara County,San Jose,1.0,0,0,0,0,0,0,0,0,0,0,0.0,0.0,0.0,0.0
1661,2023,512025,Santa Clara County,San Jose,1.0,7,0,7,7,0,7,0,0,0,7,0.0,0.5714285714285714,0.0,0.0
1662,2024,512025,Santa Clara County,San Jose,1.0,1,0,1,1,0,1,0,0,0,1,0.0,1.0,0.0,0.0
1663,All,512025,Santa Clara County,San Jose,1.0,8,0,8,8,0,8,0,0,0,8,0.0,0.625,0.0,0.0
1664,2018,512026,Santa Clara County,San Jose,1.0,0,0,0,0,0,0,0,0,0,0,0.0,0.0,0.0,0.0
1665,2019,512026,Santa Clara County,San Jose,1.0,0,0,0,0,0,0,0,0,0,0,0.0,0.0,0.0,0.0
1666,2020,512026,Santa Clara County,San Jose,1.0,0,0,0,0,0,0,0,0,0,0,0.0,0.0,0.0,0.0
1667,2021,512026,Santa Clara County,San Jose,1.0,0,0,0,0,0,0,0,0,0,0,0.0,0.0,0.0,0.0
1668,2022,512026,Santa Clara County,San Jose,1.0,0,0,0,0,0,0,0,0,0,0,0.0,0.0,0.0,0.0
1669,2023,512026,Santa Clara County,San Jose,1.0,3,0,3,3,0,3,0,0,0,3,0.0,1.0,0.0,0.0
1670,2024,512026,Santa Clara County,San Jose,1.0,0,0,0,0,0,0,0,0,0,0,0.0,0.0,0.0,0.0
1671,All,512026,Santa Clara County,San Jose,1.0,3,0,3,3,0,3,0,0,0,3,0.0,1.0,0.0,0.0
1672,2018,512027,Santa Clara County,San Jose,1.0,0,0,0,0,0,0,0,0,0,0,0.0,0.0,0.0,0.0
1673,2019,512027,Santa Clara County,San Jose,1.0,0,0,0,0,0,0,0,0,0,0,0.0,0.0,0.0,0.0
1674,2020,512027,Santa Clara County,San Jose,1.0,1,1,0,239,89,328,89,0,239,0,1.0,0.0,1.0,0.0
1675,2021,512027,Santa Clara County,San Jose,1.0,1,1,0,271,0,271,0,0,271,0,1.0,0.0,0.0,0.0
1676,2022,512027,Santa Clara County,San Jose,1.0,2,0,2,2,0,2,0,0,0,2,0.0,1.0,0.0,0.0
1677,2023,512027,Santa Clara County,San Jose,1.0,1,0,1,1,0,1,0,0,0,1,0.0,1.0,0.0,0.0
1678,2024,512027,Santa Clara County,San Jose,1.0,4,1,3,162,3,165,0,3,162,0,0.0,0.0,0.0,1.0
1679,All,512027,Santa Clara County,San Jose,1.0,9,3,6,675,92,767,89,3,672,3,0.7589285714285714,1.0,1.0,1.0
1680,2018,512029,Santa Clara County,San Jose,1.0,0,0,0,0,0,0,0,0,0,0,0.0,0.0,0.0,0.0
1681,2019,512029,Santa Clara County,San Jose,1.0,0,0,0,0,0,0,0,0,0,0,0.0,0.0,0.0,0.0
1682,2020,512029,Santa Clara County,San Jose,1.0,0,0,0,0,0,0,0,0,0,0,0.0,0.0,0.0,0.0
1683,2021,512029,Santa Clara County,San Jose,1.0,0,0,0,0,0,0,0,0,0,0,0.0,0.0,0.0,0.0
1684,2022,512029,Santa Clara County,San Jose,1.0,3,0,3,3,0,3,0,0,0,3,0.0,1.0,0.0,0.0
1685,2023,512029,Santa Clara County,San Jose,1.0,4,0,4,4,0,4,0,0,0,4,0.0,1.0,0.0,0.0
1686,2024,512029,Santa Clara County,San Jose,1.0,3,0,3,1,2,3,0,2,0,1,0.0,1.0,0.0,1.0
1687,All,512029,Santa Clara County,San Jose,1.0,10,0,10,8,2,10,0,2,0,8,0.0,1.0,0.0,1.0
1688,2018,512030,Santa Clara County,San Jose,1.0,0,0,0,0,0,0,0,0,0,0,0.0,0.0,0.0,0.0
1689,2019,512030,Santa Clara County,San Jose,1.0,0,0,0,0,0,0,0,0,0,0,0.0,0.0,0.0,0.0
1690,2020,512030,Santa Clara County,San Jose,1.0,0,0,0,0,0,0,0,0,0,0,0.0,0.0,0.0,0.0
1691,2021,512030,Santa Clara County,San Jose,1.0,0,0,0,0,0,0,0,0,0,0,0.0,0.0,0.0,0.0
1692,2022,512030,Santa Clara County,San Jose,1.0,2,0,2,2,0,2,0,0,0,2,0.0,1.0,0.0,0.0
1693,2023,512030,Santa Clara County,San Jose,1.0,1,0,1,1,0,1,0,0,0,1,0.0,1.0,0.0,0.0
1694,2024,512030,Santa Clara County,San Jose,1.0,1,0,1,0,1,1,0,1,0,0,0.0,0.0,0.0,1.0
1695,All,512030,Santa Clara County,San Jose,1.0,4,0,4,3,1,4,0,1,0,3,0.0,1.0,0.0,1.0
1696,2018,512031,Santa Clara County,San Jose,1.0,0,0,0,0,0,0,0,0,0,0,0.0,0.0,0.0,0.0
1697,2019,512031,Santa Clara County,San Jose,1.0,0,0,0,0,0,0,0,0,0,0,0.0,0.0,0.0,0.0
1698,2020,512031,Santa Clara County,San Jose,1.0,0,0,0,0,0,0,0,0,0,0,0.0,0.0,0.0,0.0
1699,2021,512031,Santa Clara County,San Jose,1.0,0,0,0,0,0,0,0,0,0,0,0.0,0.0,0.0,0.0
1700,2022,512031,Santa Clara County,San Jose,1.0,1,0,1,1,0,1,0,0,0,1,0.0,1.0,0.0,0.0
1701,2023,512031,Santa Clara County,San Jose,1.0,0,0,0,0,0,0,0,0,0,0,0.0,0.0,0.0,0.0
1702,2024,512031,Santa Clara County,San Jose,1.0,1,0,1,0,1,1,0,1,0,0,0.0,0.0,0.0,1.0
1703,All,512031,Santa Clara County,San Jose,1.0,2,0,2,1,1,2,0,1,0,1,0.0,1.0,0.0,1.0
1704,2018,512032,Santa Clara County,San Jose,1.0,0,0,0,0,0,0,0,0,0,0,0.0,0.0,0.0,0.0
1705,2019,512032,Santa Clara County,San Jose,1.0,0,0,0,0,0,0,0,0,0,0,0.0,0.0,0.0,0.0
1706,2020,512032,Santa Clara County,San Jose,1.0,0,0,0,0,0,0,0,0,0,0,0.0,0.0,0.0,0.0
1707,2021,512032,Santa Clara County,San Jose,1.0,0,0,0,0,0,0,0,0,0,0,0.0,0.0,0.0,0.0
1708,2022,512032,Santa Clara County,San Jose,1.0,0,0,0,0,0,0,0,0,0,0,0.0,0.0,0.0,0.0
1709,2023,512032,Santa Clara County,San Jose,1.0,1,0,1,1,0,1,0,0,0,1,0.0,1.0,0.0,0.0
1710,2024,512032,Santa Clara County,San Jose,1.0,1,0,1,1,0,1,0,0,0,1,0.0,1.0,0.0,0.0
1711,All,512032,Santa Clara County,San Jose,1.0,2,0,2,2,0,2,0,0,0,2,0.0,1.0,0.0,0.0
1712,2018,512034,Santa Clara County,San Jose,1.0,0,0,0,0,0,0,0,0,0,0,0.0,0.0,0.0,0.0
1713,2019,512034,Santa Clara County,San Jose,1.0,0,0,0,0,0,0,0,0,0,0,0.0,0.0,0.0,0.0
1714,2020,512034,Santa Clara County,San Jose,1.0,0,0,0,0,0,0,0,0,0,0,0.0,0.0,0.0,0.0
1715,2021,512034,Santa Clara County,San Jose,1.0,0,0,0,0,0,0,0,0,0,0,0.0,0.0,0.0,0.0
1716,2022,512034,Santa Clara County,San Jose,1.0,1,0,1,1,0,1,0,0,0,1,0.0,1.0,0.0,0.0
1717,2023,512034,Santa Clara County,San Jose,1.0,2,0,2,2,0,2,0,0,0,2,0.0,1.0,0.0,0.0
1718,2024,512034,Santa Clara County,San Jose,1.0,1,0,1,0,1,1,0,1,0,0,0.0,0.0,0.0,1.0
1719,All,512034,Santa Clara County,San Jose,1.0,4,0,4,3,1,4,0,1,0,3,0.0,1.0,0.0,1.0
1720,2018,512035,Santa Clara County,San Jose,0.852,0,0,0,0,0,0,0,0,0,0,0.0,0.0,0.0,0.0
1721,2019,512035,Santa Clara County,San Jose,0.852,0,0,0,0,0,0,0,0,0,0,0.0,0.0,0.0,0.0
1722,2020,512035,Santa Clara County,San Jose,0.852,0,0,0,0,0,0,0,0,0,0,0.0,0.0,0.0,0.0
1723,2021,512035,Santa Clara County,San Jose,0.852,0,0,0,0,0,0,0,0,0,0,0.0,0.0,0.0,0.0
1724,2022,512035,Santa Clara County,San Jose,0.852,5,0,5,5,0,5,0,0,0,5,0.0,1.0,0.0,0.0
1725,2023,512035,Santa Clara County,San Jose,0.852,2,0,2,2,0,2,0,0,0,2,0.0,1.0,0.0,0.0
1726,2024,512035,Santa Clara County,San Jose,0.852,1,0,1,0,1,1,0,1,0,0,0.0,0.0,0.0,1.0
1727,All,512035,Santa Clara County,San Jose,0.852,8,0,8,7,1,8,0,1,0,7,0.0,1.0,0.0,1.0
1728,2018,512036,Santa Clara County,San Jose,1.0,0,0,0,0,0,0,0,0,0,0,0.0,0.0,0.0,0.0
1729,2019,512036,Santa Clara County,San Jose,1.0,0,0,0,0,0,0,0,0,0,0,0.0,0.0,0.0,0.0
1730,2020,512036,Santa Clara County,San Jose,1.0,0,0,0,0,0,0,0,0,0,0,0.0,0.0,0.0,0.0
1731,2021,512036,Santa Clara County,San Jose,1.0,0,0,0,0,0,0,0,0,0,0,0.0,0.0,0.0,0.0
1732,2022,512036,Santa Clara County,San Jose,1.0,2,0,2,2,0,2,0,0,0,2,0.0,1.0,0.0,0.0
1733,2023,512036,Santa Clara County,San Jose,1.0,0,0,0,0,0,0,0,0,0,0,0.0,0.0,0.0,0.0
1734,2024,512036,Santa Clara County,San Jose,1.0,2,0,2,0,2,2,0,2,0,0,0.0,0.0,0.0,1.0
1735,All,512036,Santa Clara County,San Jose,1.0,4,0,4,2,2,4,0,2,0,2,0.0,1.0,0.0,1.0
1736,2018,512037,Santa Clara County,San Jose,1.0,0,0,0,0,0,0,0,0,0,0,0.0,0.0,0.0,0.0
1737,2019,512037,Santa Clara County,San Jose,1.0,0,0,0,0,0,0,0,0,0,0,0.0,0.0,0.0,0.0
1738,2020,512037,Santa Clara County,San Jose,1.0,0,0,0,0,0,0,0,0,0,0,0.0,0.0,0.0,0.0
1739,2021,512037,Santa Clara County,San Jose,1.0,0,0,0,0,0,0,0,0,0,0,0.0,0.0,0.0,0.0
1740,2022,512037,Santa Clara County,San Jose,1.0,2,0,2,2,0,2,0,0,0,2,0.0,1.0,0.0,0.0
1741,2023,512037,Santa Clara County,San Jose,1.0,0,0,0,0,0,0,0,0,0,0,0.0,0.0,0.0,0.0
1742,2024,512037,Santa Clara County,San Jose,1.0,1,0,1,0,1,1,0,1,0,0,0.0,0.0,0.0,1.0
1743,All,512037,Santa Clara County,San Jose,1.0,3,0,3,2,1,3,0,1,0,2,0.0,1.0,0.0,1.0
1744,2018,512038,Santa Clara County,San Jose,1.0,0,0,0,0,0,0,0,0,0,0,0.0,0.0,0.0,0.0
1745,2019,512038,Santa Clara County,San Jose,1.0,0,0,0,0,0,0,0,0,0,0,0.0,0.0,0.0,0.0
1746,2020,512038,Santa Clara County,San Jose,1.0,0,0,0,0,0,0,0,0,0,0,0.0,0.0,0.0,0.0
1747,2021,512038,Santa Clara County,San Jose,1.0,0,0,0,0,0,0,0,0,0,0,0.0,0.0,0.0,0.0
1748,2022,512038,Santa Clara County,San Jose,1.0,0,0,0,0,0,0,0,0,0,0,0.0,0.0,0.0,0.0
1749,2023,512038,Santa Clara County,San Jose,1.0,0,0,0,0,0,0,0,0,0,0,0.0,0.0,0.0,0.0
1750,2024,512038,Santa Clara County,San Jose,1.0,0,0,0,0,0,0,0,0,0,0,0.0,0.0,0.0,0.0
1751,All,512038,Santa Clara County,San Jose,1.0,0,0,0,0,0,0,0,0,0,0,0.0,0.0,0.0,0.0
1752,2018,512039,Santa Clara County,San Jose,1.0,0,0,0,0,0,0,0,0,0,0,0.0,0.0,0.0,0.0
1753,2019,512039,Santa Clara County,San Jose,1.0,0,0,0,0,0,0,0,0,0,0,0.0,0.0,0.0,0.0
1754,2020,512039,Santa Clara County,San Jose,1.0,0,0,0,0,0,0,0,0,0,0,0.0,0.0,0.0,0.0
1755,2021,512039,Santa Clara County,San Jose,1.0,0,0,0,0,0,0,0,0,0,0,0.0,0.0,0.0,0.0
1756,2022,512039,Santa Clara County,San Jose,1.0,2,0,2,2,0,2,0,0,0,2,0.0,1.0,0.0,0.0
1757,2023,512039,Santa Clara County,San Jose,1.0,1,0,1,1,0,1,0,0,0,1,0.0,1.0,0.0,0.0
1758,2024,512039,Santa Clara County,San Jose,1.0,5,0,5,0,5,5,0,5,0,0,0.0,0.0,0.0,1.0
1759,All,512039,Santa Clara County,San Jose,1.0,8,0,8,3,5,8,0,5,0,3,0.0,1.0,0.0,1.0
1760,2018,512042,Santa Clara County,San Jose,1.0,0,0,0,0,0,0,0,0,0,0,0.0,0.0,0.0,0.0
1761,2019,512042,Santa Clara County,San Jose,1.0,0,0,0,0,0,0,0,0,0,0,0.0,0.0,0.0,0.0
1762,2020,512042,Santa Clara County,San Jose,1.0,0,0,0,0,0,0,0,0,0,0,0.0,0.0,0.0,0.0
1763,2021,512042,Santa Clara County,San Jose,1.0,0,0,0,0,0,0,0,0,0,0,0.0,0.0,0.0,0.0
1764,2022,512042,Santa Clara County,San Jose,1.0,3,1,2,2,163,165,163,0,0,2,0.0,1.0,1.0,0.0
1765,2023,512042,Santa Clara County,San Jose,1.0,3,0,3,3,0,3,0,0,0,3,0.0,1.0,0.0,0.0
1766,2024,512042,Santa Clara County,San Jose,1.0,3,0,3,0,3,3,0,3,0,0,0.0,0.0,0.0,1.0
1767,All,512042,Santa Clara County,San Jose,1.0,9,1,8,5,166,171,163,3,0,5,0.0,1.0,1.0,1.0
1768,2018,512043,Santa Clara County,San Jose,1.0,0,0,0,0,0,0,0,0,0,0,0.0,0.0,0.0,0.0
1769,2019,512043,Santa Clara County,San Jose,1.0,0,0,0,0,0,0,0,0,0,0,0.0,0.0,0.0,0.0
1770,2020,512043,Santa Clara County,San Jose,1.0,0,0,0,0,0,0,0,0,0,0,0.0,0.0,0.0,0.0
1771,2021,512043,Santa Clara County,San Jose,1.0,0,0,0,0,0,0,0,0,0,0,0.0,0.0,0.0,0.0
1772,2022,512043,Santa Clara County,San Jose,1.0,5,0,5,5,0,5,0,0,0,5,0.0,1.0,0.0,0.0
1773,2023,512043,Santa Clara County,San Jose,1.0,5,1,4,6,0,6,0,0,2,4,0.0,1.0,0.0,0.0
1774,2024,512043,Santa Clara County,San Jose,1.0,4,0,4,0,4,4,0,4,0,0,0.0,0.0,0.0,1.0
1775,All,512043,Santa Clara County,San Jose,1.0,14,1,13,11,4,15,0,4,2,9,0.0,1.0,0.0,1.0
1776,2018,512045,Santa Clara County,San Jose,1.0,0,0,0,0,0,0,0,0,0,0,0.0,0.0,0.0,0.0
1777,2019,512045,Santa Clara County,San Jose,1.0,0,0,0,0,0,0,0,0,0,0,0.0,0.0,0.0,0.0
1778,2020,512045,Santa Clara County,San Jose,1.0,0,0,0,0,0,0,0,0,0,0,0.0,0.0,0.0,0.0
1779,2021,512045,Santa Clara County,San Jose,1.0,0,0,0,0,0,0,0,0,0,0,0.0,0.0,0.0,0.0
1780,2022,512045,Santa Clara County,San Jose,1.0,6,1,5,5,49,54,49,0,0,5,0.0,1.0,1.0,0.0
1781,2023,512045,Santa Clara County,San Jose,1.0,3,0,3,3,0,3,0,0,0,3,0.0,1.0,0.0,0.0
1782,2024,512045,Santa Clara County,San Jose,1.0,1,0,1,0,1,1,0,1,0,0,0.0,0.0,0.0,1.0
1783,All,512045,Santa Clara County,San Jose,1.0,10,1,9,8,50,58,49,1,0,8,0.0,1.0,1.0,1.0
1784,2018,512047,Santa Clara County,San Jose,1.0,0,0,0,0,0,0,0,0,0,0,0.0,0.0,0.0,0.0
1785,2019,512047,Santa Clara County,San Jose,1.0,0,0,0,0,0,0,0,0,0,0,0.0,0.0,0.0,0.0
1786,2020,512047,Santa Clara County,San Jose,1.0,0,0,0,0,0,0,0,0,0,0,0.0,0.0,0.0,0.0
1787,2021,512047,Santa Clara County,San Jose,1.0,0,0,0,0,0,0,0,0,0,0,0.0,0.0,0.0,0.0
1788,2022,512047,Santa Clara County,San Jose,1.0,5,0,5,5,0,5,0,0,0,5,0.0,1.0,0.0,0.0
1789,2023,512047,Santa Clara County,San Jose,1.0,7,0,7,7,0,7,0,0,0,7,0.0,1.0,0.0,0.0
1790,2024,512047,Santa Clara County,San Jose,1.0,2,0,2,0,2,2,0,2,0,0,0.0,0.0,0.0,1.0
1791,All,512047,Santa Clara County,San Jose,1.0,14,0,14,12,2,14,0,2,0,12,0.0,1.0,0.0,1.0
1792,2018,512052,Santa Clara County,San Jose,1.0,0,0,0,0,0,0,0,0,0,0,0.0,0.0,0.0,0.0
1793,2019,512052,Santa Clara County,San Jose,1.0,0,0,0,0,0,0,0,0,0,0,0.0,0.0,0.0,0.0
1794,2020,512052,Santa Clara County,San Jose,1.0,0,0,0,0,0,0,0,0,0,0,0.0,0.0,0.0,0.0
1795,2021,512052,Santa Clara County,San Jose,1.0,0,0,0,0,0,0,0,0,0,0,0.0,0.0,0.0,0.0
1796,2022,512052,Santa Clara County,San Jose,1.0,2,0,2,2,0,2,0,0,0,2,0.0,1.0,0.0,0.0
1797,2023,512052,Santa Clara County,San Jose,1.0,0,0,0,0,0,0,0,0,0,0,0.0,0.0,0.0,0.0
1798,2024,512052,Santa Clara County,San Jose,1.0,0,0,0,0,0,0,0,0,0,0,0.0,0.0,0.0,0.0
1799,All,512052,Santa Clara County,San Jose,1.0,2,0,2,2,0,2,0,0,0,2,0.0,1.0,0.0,0.0
1800,2018,512053,Santa Clara County,San Jose,1.0,0,0,0,0,0,0,0,0,0,0,0.0,0.0,0.0,0.0
1801,2019,512053,Santa Clara County,San Jose,1.0,0,0,0,0,0,0,0,0,0,0,0.0,0.0,0.0,0.0
1802,2020,512053,Santa Clara County,San Jose,1.0,0,0,0,0,0,0,0,0,0,0,0.0,0.0,0.0,0.0
1803,2021,512053,Santa Clara County,San Jose,1.0,0,0,0,0,0,0,0,0,0,0,0.0,0.0,0.0,0.0
1804,2022,512053,Santa Clara County,San Jose,1.0,0,0,0,0,0,0,0,0,0,0,0.0,0.0,0.0,0.0
1805,2023,512053,Santa Clara County,San Jose,1.0,1,0,1,1,0,1,0,0,0,1,0.0,1.0,0.0,0.0
1806,2024,512053,Santa Clara County,San Jose,1.0,1,0,1,1,0,1,0,0,0,1,0.0,1.0,0.0,0.0
1807,All,512053,Santa Clara County,San Jose,1.0,2,0,2,2,0,2,0,0,0,2,0.0,1.0,0.0,0.0
1808,2018,512054,Santa Clara County,San Jose,1.0,0,0,0,0,0,0,0,0,0,0,0.0,0.0,0.0,0.0
1809,2019,512054,Santa Clara County,San Jose,1.0,0,0,0,0,0,0,0,0,0,0,0.0,0.0,0.0,0.0
1810,2020,512054,Santa Clara County,San Jose,1.0,0,0,0,0,0,0,0,0,0,0,0.0,0.0,0.0,0.0
1811,2021,512054,Santa Clara County,San Jose,1.0,0,0,0,0,0,0,0,0,0,0,0.0,0.0,0.0,0.0
1812,2022,512054,Santa Clara County,San Jose,1.0,0,0,0,0,0,0,0,0,0,0,0.0,0.0,0.0,0.0
1813,2023,512054,Santa Clara County,San Jose,1.0,0,0,0,0,0,0,0,0,0,0,0.0,0.0,0.0,0.0
1814,2024,512054,Santa Clara County,San Jose,1.0,0,0,0,0,0,0,0,0,0,0,0.0,0.0,0.0,0.0
1815,All,512054,Santa Clara County,San Jose,1.0,0,0,0,0,0,0,0,0,0,0,0.0,0.0,0.0,0.0
1816,2018,512055,Santa Clara County,San Jose,1.0,0,0,0,0,0,0,0,0,0,0,0.0,0.0,0.0,0.0
1817,2019,512055,Santa Clara County,San Jose,1.0,0,0,0,0,0,0,0,0,0,0,0.0,0.0,0.0,0.0
1818,2020,512055,Santa Clara County,San Jose,1.0,0,0,0,0,0,0,0,0,0,0,0.0,0.0,0.0,0.0
1819,2021,512055,Santa Clara County,San Jose,1.0,0,0,0,0,0,0,0,0,0,0,0.0,0.0,0.0,0.0
1820,2022,512055,Santa Clara County,San Jose,1.0,0,0,0,0,0,0,0,0,0,0,0.0,0.0,0.0,0.0
1821,2023,512055,Santa Clara County,San Jose,1.0,0,0,0,0,0,0,0,0,0,0,0.0,0.0,0.0,0.0
1822,2024,512055,Santa Clara County,San Jose,1.0,0,0,0,0,0,0,0,0,0,0,0.0,0.0,0.0,0.0
1823,All,512055,Santa Clara County,San Jose,1.0,0,0,0,0,0,0,0,0,0,0,0.0,0.0,0.0,0.0
1824,2018,512056,Santa Clara County,San Jose,1.0,0,0,0,0,0,0,0,0,0,0,0.0,0.0,0.0,0.0
1825,2019,512056,Santa Clara County,San Jose,1.0,0,0,0,0,0,0,0,0,0,0,0.0,0.0,0.0,0.0
1826,2020,512056,Santa Clara County,San Jose,1.0,0,0,0,0,0,0,0,0,0,0,0.0,0.0,0.0,0.0
1827,2021,512056,Santa Clara County,San Jose,1.0,0,0,0,0,0,0,0,0,0,0,0.0,0.0,0.0,0.0
1828,2022,512056,Santa Clara County,San Jose,1.0,3,0,3,3,0,3,0,0,0,3,0.0,1.0,0.0,0.0
1829,2023,512056,Santa Clara County,San Jose,1.0,4,0,4,4,0,4,0,0,0,4,0.0,1.0,0.0,0.0
1830,2024,512056,Santa Clara County,San Jose,1.0,2,0,2,0,2,2,0,2,0,0,0.0,0.0,0.0,1.0
1831,All,512056,Santa Clara County,San Jose,1.0,9,0,9,7,2,9,0,2,0,7,0.0,1.0,0.0,1.0
1832,2018,512057,Santa Clara County,San Jose,1.0,0,0,0,0,0,0,0,0,0,0,0.0,0.0,0.0,0.0
1833,2019,512057,Santa Clara County,San Jose,1.0,0,0,0,0,0,0,0,0,0,0,0.0,0.0,0.0,0.0
1834,2020,512057,Santa Clara County,San Jose,1.0,1,1,0,0,438,438,438,0,0,0,0.0,0.0,1.0,0.0
1835,2021,512057,Santa Clara County,San Jose,1.0,0,0,0,0,0,0,0,0,0,0,0.0,0.0,0.0,0.0
1836,2022,512057,Santa Clara County,San Jose,1.0,3,0,3,3,0,3,0,0,0,3,0.0,1.0,0.0,0.0
1837,2023,512057,Santa Clara County,San Jose,1.0,7,1,6,10,362,372,362,0,4,6,1.0,1.0,1.0,0.0
1838,2024,512057,Santa Clara County,San Jose,1.0,4,0,4,0,4,4,0,4,0,0,0.0,0.0,0.0,1.0
1839,All,512057,Santa Clara County,San Jose,1.0,15,2,13,13,804,817,800,4,4,9,1.0,1.0,1.0,1.0
1840,2018,512058,Santa Clara County,San Jose,1.0,0,0,0,0,0,0,0,0,0,0,0.0,0.0,0.0,0.0
1841,2019,512058,Santa Clara County,San Jose,1.0,0,0,0,0,0,0,0,0,0,0,0.0,0.0,0.0,0.0
1842,2020,512058,Santa Clara County,San Jose,1.0,0,0,0,0,0,0,0,0,0,0,0.0,0.0,0.0,0.0
1843,2021,512058,Santa Clara County,San Jose,1.0,0,0,0,0,0,0,0,0,0,0,0.0,0.0,0.0,0.0
1844,2022,512058,Santa Clara County,San Jose,1.0,0,0,0,0,0,0,0,0,0,0,0.0,0.0,0.0,0.0
1845,2023,512058,Santa Clara County,San Jose,1.0,0,0,0,0,0,0,0,0,0,0,0.0,0.0,0.0,0.0
1846,2024,512058,Santa Clara County,San Jose,1.0,1,0,1,0,1,1,0,1,0,0,0.0,0.0,0.0,1.0
1847,All,512058,Santa Clara County,San Jose,1.0,1,0,1,0,1,1,0,1,0,0,0.0,0.0,0.0,1.0
1848,2018,512059,Santa Clara County,San Jose,1.0,0,0,0,0,0,0,0,0,0,0,0.0,0.0,0.0,0.0
1849,2019,512059,Santa Clara County,San Jose,1.0,0,0,0,0,0,0,0,0,0,0,0.0,0.0,0.0,0.0
1850,2020,512059,Santa Clara County,San Jose,1.0,0,0,0,0,0,0,0,0,0,0,0.0,0.0,0.0,0.0
1851,2021,512059,Santa Clara County,San Jose,1.0,0,0,0,0,0,0,0,0,0,0,0.0,0.0,0.0,0.0
1852,2022,512059,Santa Clara County,San Jose,1.0,1,0,1,1,0,1,0,0,0,1,0.0,1.0,0.0,0.0
1853,2023,512059,Santa Clara County,San Jose,1.0,0,0,0,0,0,0,0,0,0,0,0.0,0.0,0.0,0.0
1854,2024,512059,Santa Clara County,San Jose,1.0,0,0,0,0,0,0,0,0,0,0,0.0,0.0,0.0,0.0
1855,All,512059,Santa Clara County,San Jose,1.0,1,0,1,1,0,1,0,0,0,1,0.0,1.0,0.0,0.0
1856,2018,512100,Santa Clara County,San Jose,0.371,0,0,0,0,0,0,0,0,0,0,0.0,0.0,0.0,0.0
1857,2019,512100,Santa Clara County,San Jose,0.371,0,0,0,0,0,0,0,0,0,0,0.0,0.0,0.0,0.0
1858,2020,512100,Santa Clara County,San Jose,0.371,0,0,0,0,0,0,0,0,0,0,0.0,0.0,0.0,0.0
1859,2021,512100,Santa Clara County,San Jose,0.371,0,0,0,0,0,0,0,0,0,0,0.0,0.0,0.0,0.0
1860,2022,512100,Santa Clara County,San Jose,0.371,0,0,0,0,0,0,0,0,0,0,0.0,0.0,0.0,0.0
1861,2023,512100,Santa Clara County,San Jose,0.371,0,0,0,0,0,0,0,0,0,0,0.0,0.0,0.0,0.0
1862,2024,512100,Santa Clara County,San Jose,0.371,0,0,0,0,0,0,0,0,0,0,0.0,0.0,0.0,0.0
1863,All,512100,Santa Clara County,San Jose,0.371,0,0,0,0,0,0,0,0,0,0,0.0,0.0,0.0,0.0
1864,2018,512200,Santa Clara County,San Jose,0.041,0,0,0,0,0,0,0,0,0,0,0.0,0.0,0.0,0.0
1865,2019,512200,Santa Clara County,San Jose,0.041,0,0,0,0,0,0,0,0,0,0,0.0,0.0,0.0,0.0
1866,2020,512200,Santa Clara County,San Jose,0.041,0,0,0,0,0,0,0,0,0,0,0.0,0.0,0.0,0.0
1867,2021,512200,Santa Clara County,San Jose,0.041,0,0,0,0,0,0,0,0,0,0,0.0,0.0,0.0,0.0
1868,2022,512200,Santa Clara County,San Jose,0.041,0,0,0,0,0,0,0,0,0,0,0.0,0.0,0.0,0.0
1869,2023,512200,Santa Clara County,San Jose,0.041,0,0,0,0,0,0,0,0,0,0,0.0,0.0,0.0,0.0
1870,2024,512200,Santa Clara County,San Jose,0.041,0,0,0,0,0,0,0,0,0,0,0.0,0.0,0.0,0.0
1871,All,512200,Santa Clara County,San Jose,0.041,0,0,0,0,0,0,0,0,0,0,0.0,0.0,0.0,0.0
1872,2018,512311,Santa Clara County,San Jose,0.09,0,0,0,0,0,0,0,0,0,0,0.0,0.0,0.0,0.0
1873,2019,512311,Santa Clara County,San Jose,0.09,0,0,0,0,0,0,0,0,0,0,0.0,0.0,0.0,0.0
1874,2020,512311,Santa Clara County,San Jose,0.09,0,0,0,0,0,0,0,0,0,0,0.0,0.0,0.0,0.0
1875,2021,512311,Santa Clara County,San Jose,0.09,0,0,0,0,0,0,0,0,0,0,0.0,0.0,0.0,0.0
1876,2022,512311,Santa Clara County,San Jose,0.09,0,0,0,0,0,0,0,0,0,0,0.0,0.0,0.0,0.0
1877,2023,512311,Santa Clara County,San Jose,0.09,0,0,0,0,0,0,0,0,0,0,0.0,0.0,0.0,0.0
1878,2024,512311,Santa Clara County,San Jose,0.09,0,0,0,0,0,0,0,0,0,0,0.0,0.0,0.0,0.0
1879,All,512311,Santa Clara County,San Jose,0.09,0,0,0,0,0,0,0,0,0,0,0.0,0.0,0.0,0.0
1880,2018,513500,Santa Clara County,San Jose,0.022,0,0,0,0,0,0,0,0,0,0,0.0,0.0,0.0,0.0
1881,2019,513500,Santa Clara County,San Jose,0.022,0,0,0,0,0,0,0,0,0,0,0.0,0.0,0.0,0.0
1882,2020,513500,Santa Clara County,San Jose,0.022,0,0,0,0,0,0,0,0,0,0,0.0,0.0,0.0,0.0
1883,2021,513500,Santa Clara County,San Jose,0.022,0,0,0,0,0,0,0,0,0,0,0.0,0.0,0.0,0.0
1884,2022,513500,Santa Clara County,San Jose,0.022,0,0,0,0,0,0,0,0,0,0,0.0,0.0,0.0,0.0
1885,2023,513500,Santa Clara County,San Jose,0.022,0,0,0,0,0,0,0,0,0,0,0.0,0.0,0.0,0.0
1886,2024,513500,Santa Clara County,San Jose,0.022,0,0,0,0,0,0,0,0,0,0,0.0,0.0,0.0,0.0
1887,All,513500,Santa Clara County,San Jose,0.022,0,0,0,0,0,0,0,0,0,0,0.0,0.0,0.0,0.0
